"","ModuleID","NumOfGenesFromSpe1","NumOfGenesFromSpe2","TotalNumOfGenesFromModule","RatioOfGenesFromSpe1","RatioOfGenesFromSpe2"
"1",191,81,63,144,0.562,0.438
"2",1,87,46,133,0.654,0.346
"3",6645,61,42,103,0.592,0.408
"4",25,52,42,94,0.553,0.447
"5",4541,17,58,75,0.227,0.773
"6",4578,17,50,67,0.254,0.746
"7",4545,3,18,21,0.143,0.857
"8",193,7,0,7,1,0
"9",24,3,1,4,0.75,0.25
"10",36,3,1,4,0.75,0.25
"11",78,3,1,4,0.75,0.25
"12",82,3,1,4,0.75,0.25
"13",100,4,0,4,1,0
"14",135,3,1,4,0.75,0.25
"15",212,3,1,4,0.75,0.25
"16",368,1,3,4,0.25,0.75
"17",4552,0,4,4,0,1
"18",6251,3,1,4,0.75,0.25
"19",7648,3,1,4,0.75,0.25
"20",2,2,1,3,0.667,0.333
"21",3,2,1,3,0.667,0.333
"22",6,2,1,3,0.667,0.333
"23",7,2,1,3,0.667,0.333
"24",8,3,0,3,1,0
"25",12,2,1,3,0.667,0.333
"26",33,2,1,3,0.667,0.333
"27",34,2,1,3,0.667,0.333
"28",35,3,0,3,1,0
"29",38,2,1,3,0.667,0.333
"30",41,2,1,3,0.667,0.333
"31",46,2,1,3,0.667,0.333
"32",59,2,1,3,0.667,0.333
"33",67,2,1,3,0.667,0.333
"34",73,2,1,3,0.667,0.333
"35",96,3,0,3,1,0
"36",107,2,1,3,0.667,0.333
"37",121,2,1,3,0.667,0.333
"38",122,2,1,3,0.667,0.333
"39",124,2,1,3,0.667,0.333
"40",131,2,1,3,0.667,0.333
"41",141,1,2,3,0.333,0.667
"42",158,1,2,3,0.333,0.667
"43",159,2,1,3,0.667,0.333
"44",162,2,1,3,0.667,0.333
"45",167,2,1,3,0.667,0.333
"46",185,2,1,3,0.667,0.333
"47",215,2,1,3,0.667,0.333
"48",216,2,1,3,0.667,0.333
"49",228,3,0,3,1,0
"50",234,2,1,3,0.667,0.333
"51",241,2,1,3,0.667,0.333
"52",262,2,1,3,0.667,0.333
"53",375,1,2,3,0.333,0.667
"54",395,1,2,3,0.333,0.667
"55",830,1,2,3,0.333,0.667
"56",1090,1,2,3,0.333,0.667
"57",1193,1,2,3,0.333,0.667
"58",1194,1,2,3,0.333,0.667
"59",1225,1,2,3,0.333,0.667
"60",1316,1,2,3,0.333,0.667
"61",1665,1,2,3,0.333,0.667
"62",2549,1,2,3,0.333,0.667
"63",2593,1,2,3,0.333,0.667
"64",2780,1,2,3,0.333,0.667
"65",2884,1,2,3,0.333,0.667
"66",3110,1,2,3,0.333,0.667
"67",3249,1,2,3,0.333,0.667
"68",3520,1,2,3,0.333,0.667
"69",3696,1,2,3,0.333,0.667
"70",3889,1,2,3,0.333,0.667
"71",4561,1,2,3,0.333,0.667
"72",4590,2,1,3,0.667,0.333
"73",4651,2,1,3,0.667,0.333
"74",4757,2,1,3,0.667,0.333
"75",4931,1,2,3,0.333,0.667
"76",5023,2,1,3,0.667,0.333
"77",5424,2,1,3,0.667,0.333
"78",5459,2,1,3,0.667,0.333
"79",5541,1,2,3,0.333,0.667
"80",5563,2,1,3,0.667,0.333
"81",5620,2,1,3,0.667,0.333
"82",5631,2,1,3,0.667,0.333
"83",5810,2,1,3,0.667,0.333
"84",5991,2,1,3,0.667,0.333
"85",6280,2,1,3,0.667,0.333
"86",6334,2,1,3,0.667,0.333
"87",6561,2,1,3,0.667,0.333
"88",6589,2,1,3,0.667,0.333
"89",6652,2,1,3,0.667,0.333
"90",6711,2,1,3,0.667,0.333
"91",6749,2,1,3,0.667,0.333
"92",6758,2,1,3,0.667,0.333
"93",6917,2,1,3,0.667,0.333
"94",6951,2,1,3,0.667,0.333
"95",6986,2,1,3,0.667,0.333
"96",7117,2,1,3,0.667,0.333
"97",7168,2,1,3,0.667,0.333
"98",7180,2,1,3,0.667,0.333
"99",7301,2,1,3,0.667,0.333
"100",7378,1,2,3,0.333,0.667
"101",7604,1,2,3,0.333,0.667
"102",7742,2,1,3,0.667,0.333
"103",7825,2,1,3,0.667,0.333
"104",7833,2,1,3,0.667,0.333
"105",8432,2,1,3,0.667,0.333
"106",8484,2,1,3,0.667,0.333
"107",8588,2,1,3,0.667,0.333
"108",8637,1,2,3,0.333,0.667
"109",8656,2,1,3,0.667,0.333
"110",8709,1,2,3,0.333,0.667
"111",8758,2,1,3,0.667,0.333
"112",8762,1,2,3,0.333,0.667
"113",4,1,1,2,0.5,0.5
"114",5,1,1,2,0.5,0.5
"115",9,1,1,2,0.5,0.5
"116",10,1,1,2,0.5,0.5
"117",11,1,1,2,0.5,0.5
"118",13,1,1,2,0.5,0.5
"119",14,1,1,2,0.5,0.5
"120",15,1,1,2,0.5,0.5
"121",16,1,1,2,0.5,0.5
"122",17,1,1,2,0.5,0.5
"123",18,1,1,2,0.5,0.5
"124",19,1,1,2,0.5,0.5
"125",20,1,1,2,0.5,0.5
"126",21,1,1,2,0.5,0.5
"127",22,1,1,2,0.5,0.5
"128",23,1,1,2,0.5,0.5
"129",26,1,1,2,0.5,0.5
"130",27,1,1,2,0.5,0.5
"131",28,1,1,2,0.5,0.5
"132",29,2,0,2,1,0
"133",30,1,1,2,0.5,0.5
"134",31,1,1,2,0.5,0.5
"135",32,1,1,2,0.5,0.5
"136",37,1,1,2,0.5,0.5
"137",39,1,1,2,0.5,0.5
"138",40,1,1,2,0.5,0.5
"139",42,1,1,2,0.5,0.5
"140",43,1,1,2,0.5,0.5
"141",44,1,1,2,0.5,0.5
"142",45,1,1,2,0.5,0.5
"143",47,1,1,2,0.5,0.5
"144",48,1,1,2,0.5,0.5
"145",49,1,1,2,0.5,0.5
"146",50,1,1,2,0.5,0.5
"147",51,1,1,2,0.5,0.5
"148",52,1,1,2,0.5,0.5
"149",53,1,1,2,0.5,0.5
"150",54,1,1,2,0.5,0.5
"151",55,1,1,2,0.5,0.5
"152",56,1,1,2,0.5,0.5
"153",57,1,1,2,0.5,0.5
"154",58,1,1,2,0.5,0.5
"155",60,1,1,2,0.5,0.5
"156",61,2,0,2,1,0
"157",62,1,1,2,0.5,0.5
"158",63,1,1,2,0.5,0.5
"159",64,1,1,2,0.5,0.5
"160",65,1,1,2,0.5,0.5
"161",66,1,1,2,0.5,0.5
"162",68,1,1,2,0.5,0.5
"163",69,1,1,2,0.5,0.5
"164",70,1,1,2,0.5,0.5
"165",71,1,1,2,0.5,0.5
"166",72,1,1,2,0.5,0.5
"167",74,1,1,2,0.5,0.5
"168",75,1,1,2,0.5,0.5
"169",76,1,1,2,0.5,0.5
"170",77,1,1,2,0.5,0.5
"171",79,1,1,2,0.5,0.5
"172",80,1,1,2,0.5,0.5
"173",81,2,0,2,1,0
"174",83,1,1,2,0.5,0.5
"175",84,1,1,2,0.5,0.5
"176",85,1,1,2,0.5,0.5
"177",86,1,1,2,0.5,0.5
"178",87,1,1,2,0.5,0.5
"179",88,1,1,2,0.5,0.5
"180",89,1,1,2,0.5,0.5
"181",90,1,1,2,0.5,0.5
"182",91,1,1,2,0.5,0.5
"183",92,1,1,2,0.5,0.5
"184",93,1,1,2,0.5,0.5
"185",94,1,1,2,0.5,0.5
"186",95,1,1,2,0.5,0.5
"187",97,1,1,2,0.5,0.5
"188",98,1,1,2,0.5,0.5
"189",99,1,1,2,0.5,0.5
"190",101,1,1,2,0.5,0.5
"191",102,2,0,2,1,0
"192",103,1,1,2,0.5,0.5
"193",104,1,1,2,0.5,0.5
"194",105,1,1,2,0.5,0.5
"195",106,1,1,2,0.5,0.5
"196",108,1,1,2,0.5,0.5
"197",109,2,0,2,1,0
"198",110,1,1,2,0.5,0.5
"199",111,1,1,2,0.5,0.5
"200",112,1,1,2,0.5,0.5
"201",113,1,1,2,0.5,0.5
"202",114,1,1,2,0.5,0.5
"203",115,1,1,2,0.5,0.5
"204",116,1,1,2,0.5,0.5
"205",117,1,1,2,0.5,0.5
"206",118,1,1,2,0.5,0.5
"207",119,1,1,2,0.5,0.5
"208",120,1,1,2,0.5,0.5
"209",123,1,1,2,0.5,0.5
"210",125,1,1,2,0.5,0.5
"211",126,1,1,2,0.5,0.5
"212",127,1,1,2,0.5,0.5
"213",128,1,1,2,0.5,0.5
"214",129,1,1,2,0.5,0.5
"215",130,1,1,2,0.5,0.5
"216",132,1,1,2,0.5,0.5
"217",133,1,1,2,0.5,0.5
"218",134,1,1,2,0.5,0.5
"219",136,1,1,2,0.5,0.5
"220",137,1,1,2,0.5,0.5
"221",138,1,1,2,0.5,0.5
"222",139,1,1,2,0.5,0.5
"223",140,1,1,2,0.5,0.5
"224",142,1,1,2,0.5,0.5
"225",143,2,0,2,1,0
"226",144,1,1,2,0.5,0.5
"227",145,1,1,2,0.5,0.5
"228",146,1,1,2,0.5,0.5
"229",147,1,1,2,0.5,0.5
"230",148,1,1,2,0.5,0.5
"231",149,1,1,2,0.5,0.5
"232",150,1,1,2,0.5,0.5
"233",151,1,1,2,0.5,0.5
"234",152,1,1,2,0.5,0.5
"235",153,1,1,2,0.5,0.5
"236",154,1,1,2,0.5,0.5
"237",155,1,1,2,0.5,0.5
"238",156,1,1,2,0.5,0.5
"239",157,1,1,2,0.5,0.5
"240",160,2,0,2,1,0
"241",161,1,1,2,0.5,0.5
"242",163,1,1,2,0.5,0.5
"243",164,1,1,2,0.5,0.5
"244",165,1,1,2,0.5,0.5
"245",166,1,1,2,0.5,0.5
"246",168,1,1,2,0.5,0.5
"247",169,1,1,2,0.5,0.5
"248",170,1,1,2,0.5,0.5
"249",171,1,1,2,0.5,0.5
"250",172,1,1,2,0.5,0.5
"251",173,2,0,2,1,0
"252",174,1,1,2,0.5,0.5
"253",175,1,1,2,0.5,0.5
"254",176,1,1,2,0.5,0.5
"255",177,1,1,2,0.5,0.5
"256",178,1,1,2,0.5,0.5
"257",179,1,1,2,0.5,0.5
"258",180,1,1,2,0.5,0.5
"259",181,1,1,2,0.5,0.5
"260",182,1,1,2,0.5,0.5
"261",183,1,1,2,0.5,0.5
"262",184,1,1,2,0.5,0.5
"263",186,1,1,2,0.5,0.5
"264",187,1,1,2,0.5,0.5
"265",188,1,1,2,0.5,0.5
"266",189,1,1,2,0.5,0.5
"267",190,1,1,2,0.5,0.5
"268",192,1,1,2,0.5,0.5
"269",194,1,1,2,0.5,0.5
"270",195,1,1,2,0.5,0.5
"271",196,1,1,2,0.5,0.5
"272",197,1,1,2,0.5,0.5
"273",198,1,1,2,0.5,0.5
"274",199,1,1,2,0.5,0.5
"275",200,1,1,2,0.5,0.5
"276",201,2,0,2,1,0
"277",202,1,1,2,0.5,0.5
"278",203,1,1,2,0.5,0.5
"279",204,1,1,2,0.5,0.5
"280",205,1,1,2,0.5,0.5
"281",206,1,1,2,0.5,0.5
"282",207,1,1,2,0.5,0.5
"283",208,1,1,2,0.5,0.5
"284",209,1,1,2,0.5,0.5
"285",210,1,1,2,0.5,0.5
"286",211,1,1,2,0.5,0.5
"287",213,1,1,2,0.5,0.5
"288",214,1,1,2,0.5,0.5
"289",217,2,0,2,1,0
"290",218,1,1,2,0.5,0.5
"291",219,1,1,2,0.5,0.5
"292",220,1,1,2,0.5,0.5
"293",221,1,1,2,0.5,0.5
"294",222,1,1,2,0.5,0.5
"295",223,1,1,2,0.5,0.5
"296",224,1,1,2,0.5,0.5
"297",225,1,1,2,0.5,0.5
"298",226,1,1,2,0.5,0.5
"299",227,1,1,2,0.5,0.5
"300",229,1,1,2,0.5,0.5
"301",230,1,1,2,0.5,0.5
"302",231,1,1,2,0.5,0.5
"303",232,1,1,2,0.5,0.5
"304",233,1,1,2,0.5,0.5
"305",235,1,1,2,0.5,0.5
"306",236,1,1,2,0.5,0.5
"307",237,1,1,2,0.5,0.5
"308",238,1,1,2,0.5,0.5
"309",239,1,1,2,0.5,0.5
"310",240,1,1,2,0.5,0.5
"311",242,1,1,2,0.5,0.5
"312",243,1,1,2,0.5,0.5
"313",244,1,1,2,0.5,0.5
"314",245,1,1,2,0.5,0.5
"315",246,2,0,2,1,0
"316",247,1,1,2,0.5,0.5
"317",248,1,1,2,0.5,0.5
"318",249,1,1,2,0.5,0.5
"319",250,1,1,2,0.5,0.5
"320",251,1,1,2,0.5,0.5
"321",252,1,1,2,0.5,0.5
"322",253,1,1,2,0.5,0.5
"323",254,1,1,2,0.5,0.5
"324",255,1,1,2,0.5,0.5
"325",256,1,1,2,0.5,0.5
"326",257,1,1,2,0.5,0.5
"327",258,1,1,2,0.5,0.5
"328",259,1,1,2,0.5,0.5
"329",260,1,1,2,0.5,0.5
"330",261,1,1,2,0.5,0.5
"331",263,1,1,2,0.5,0.5
"332",264,1,1,2,0.5,0.5
"333",265,1,1,2,0.5,0.5
"334",266,1,1,2,0.5,0.5
"335",267,1,1,2,0.5,0.5
"336",268,1,1,2,0.5,0.5
"337",269,1,1,2,0.5,0.5
"338",270,1,1,2,0.5,0.5
"339",271,1,1,2,0.5,0.5
"340",272,1,1,2,0.5,0.5
"341",273,1,1,2,0.5,0.5
"342",274,1,1,2,0.5,0.5
"343",275,1,1,2,0.5,0.5
"344",276,1,1,2,0.5,0.5
"345",277,1,1,2,0.5,0.5
"346",278,2,0,2,1,0
"347",279,1,1,2,0.5,0.5
"348",280,1,1,2,0.5,0.5
"349",281,1,1,2,0.5,0.5
"350",282,1,1,2,0.5,0.5
"351",283,1,1,2,0.5,0.5
"352",284,1,1,2,0.5,0.5
"353",285,1,1,2,0.5,0.5
"354",286,1,1,2,0.5,0.5
"355",287,1,1,2,0.5,0.5
"356",288,1,1,2,0.5,0.5
"357",289,1,1,2,0.5,0.5
"358",290,1,1,2,0.5,0.5
"359",291,1,1,2,0.5,0.5
"360",292,1,1,2,0.5,0.5
"361",293,1,1,2,0.5,0.5
"362",294,1,1,2,0.5,0.5
"363",295,1,1,2,0.5,0.5
"364",296,1,1,2,0.5,0.5
"365",297,1,1,2,0.5,0.5
"366",298,1,1,2,0.5,0.5
"367",299,1,1,2,0.5,0.5
"368",300,1,1,2,0.5,0.5
"369",301,1,1,2,0.5,0.5
"370",302,1,1,2,0.5,0.5
"371",303,1,1,2,0.5,0.5
"372",304,1,1,2,0.5,0.5
"373",305,1,1,2,0.5,0.5
"374",306,1,1,2,0.5,0.5
"375",307,1,1,2,0.5,0.5
"376",308,1,1,2,0.5,0.5
"377",309,1,1,2,0.5,0.5
"378",310,1,1,2,0.5,0.5
"379",311,1,1,2,0.5,0.5
"380",312,1,1,2,0.5,0.5
"381",313,1,1,2,0.5,0.5
"382",314,1,1,2,0.5,0.5
"383",315,1,1,2,0.5,0.5
"384",316,1,1,2,0.5,0.5
"385",317,1,1,2,0.5,0.5
"386",318,1,1,2,0.5,0.5
"387",319,1,1,2,0.5,0.5
"388",320,1,1,2,0.5,0.5
"389",321,1,1,2,0.5,0.5
"390",322,1,1,2,0.5,0.5
"391",323,1,1,2,0.5,0.5
"392",324,1,1,2,0.5,0.5
"393",325,1,1,2,0.5,0.5
"394",326,1,1,2,0.5,0.5
"395",327,1,1,2,0.5,0.5
"396",328,1,1,2,0.5,0.5
"397",329,1,1,2,0.5,0.5
"398",330,1,1,2,0.5,0.5
"399",331,1,1,2,0.5,0.5
"400",332,1,1,2,0.5,0.5
"401",333,1,1,2,0.5,0.5
"402",334,1,1,2,0.5,0.5
"403",335,1,1,2,0.5,0.5
"404",336,1,1,2,0.5,0.5
"405",337,1,1,2,0.5,0.5
"406",338,1,1,2,0.5,0.5
"407",339,1,1,2,0.5,0.5
"408",340,1,1,2,0.5,0.5
"409",341,1,1,2,0.5,0.5
"410",342,1,1,2,0.5,0.5
"411",343,1,1,2,0.5,0.5
"412",344,1,1,2,0.5,0.5
"413",345,1,1,2,0.5,0.5
"414",346,1,1,2,0.5,0.5
"415",347,1,1,2,0.5,0.5
"416",348,1,1,2,0.5,0.5
"417",349,1,1,2,0.5,0.5
"418",350,1,1,2,0.5,0.5
"419",351,1,1,2,0.5,0.5
"420",352,1,1,2,0.5,0.5
"421",353,1,1,2,0.5,0.5
"422",354,1,1,2,0.5,0.5
"423",355,1,1,2,0.5,0.5
"424",356,1,1,2,0.5,0.5
"425",357,1,1,2,0.5,0.5
"426",358,1,1,2,0.5,0.5
"427",359,1,1,2,0.5,0.5
"428",360,1,1,2,0.5,0.5
"429",361,1,1,2,0.5,0.5
"430",362,1,1,2,0.5,0.5
"431",363,1,1,2,0.5,0.5
"432",364,1,1,2,0.5,0.5
"433",365,1,1,2,0.5,0.5
"434",366,1,1,2,0.5,0.5
"435",367,1,1,2,0.5,0.5
"436",369,1,1,2,0.5,0.5
"437",370,1,1,2,0.5,0.5
"438",371,1,1,2,0.5,0.5
"439",372,1,1,2,0.5,0.5
"440",373,1,1,2,0.5,0.5
"441",374,1,1,2,0.5,0.5
"442",376,1,1,2,0.5,0.5
"443",377,1,1,2,0.5,0.5
"444",378,1,1,2,0.5,0.5
"445",379,1,1,2,0.5,0.5
"446",380,1,1,2,0.5,0.5
"447",381,1,1,2,0.5,0.5
"448",382,1,1,2,0.5,0.5
"449",383,1,1,2,0.5,0.5
"450",384,1,1,2,0.5,0.5
"451",385,1,1,2,0.5,0.5
"452",386,1,1,2,0.5,0.5
"453",387,1,1,2,0.5,0.5
"454",388,1,1,2,0.5,0.5
"455",389,1,1,2,0.5,0.5
"456",390,1,1,2,0.5,0.5
"457",391,1,1,2,0.5,0.5
"458",392,1,1,2,0.5,0.5
"459",393,1,1,2,0.5,0.5
"460",394,1,1,2,0.5,0.5
"461",396,1,1,2,0.5,0.5
"462",397,1,1,2,0.5,0.5
"463",398,1,1,2,0.5,0.5
"464",399,1,1,2,0.5,0.5
"465",400,1,1,2,0.5,0.5
"466",401,1,1,2,0.5,0.5
"467",402,1,1,2,0.5,0.5
"468",403,1,1,2,0.5,0.5
"469",404,1,1,2,0.5,0.5
"470",405,1,1,2,0.5,0.5
"471",406,1,1,2,0.5,0.5
"472",407,1,1,2,0.5,0.5
"473",408,1,1,2,0.5,0.5
"474",409,1,1,2,0.5,0.5
"475",410,1,1,2,0.5,0.5
"476",411,1,1,2,0.5,0.5
"477",412,1,1,2,0.5,0.5
"478",413,1,1,2,0.5,0.5
"479",414,1,1,2,0.5,0.5
"480",415,1,1,2,0.5,0.5
"481",416,1,1,2,0.5,0.5
"482",417,1,1,2,0.5,0.5
"483",418,1,1,2,0.5,0.5
"484",419,1,1,2,0.5,0.5
"485",420,1,1,2,0.5,0.5
"486",421,1,1,2,0.5,0.5
"487",422,1,1,2,0.5,0.5
"488",423,1,1,2,0.5,0.5
"489",424,1,1,2,0.5,0.5
"490",425,1,1,2,0.5,0.5
"491",426,1,1,2,0.5,0.5
"492",427,1,1,2,0.5,0.5
"493",428,1,1,2,0.5,0.5
"494",429,1,1,2,0.5,0.5
"495",430,1,1,2,0.5,0.5
"496",431,1,1,2,0.5,0.5
"497",432,1,1,2,0.5,0.5
"498",433,1,1,2,0.5,0.5
"499",434,1,1,2,0.5,0.5
"500",435,1,1,2,0.5,0.5
"501",436,1,1,2,0.5,0.5
"502",437,1,1,2,0.5,0.5
"503",438,1,1,2,0.5,0.5
"504",439,1,1,2,0.5,0.5
"505",440,1,1,2,0.5,0.5
"506",441,1,1,2,0.5,0.5
"507",442,1,1,2,0.5,0.5
"508",443,1,1,2,0.5,0.5
"509",444,1,1,2,0.5,0.5
"510",445,1,1,2,0.5,0.5
"511",446,1,1,2,0.5,0.5
"512",447,1,1,2,0.5,0.5
"513",448,1,1,2,0.5,0.5
"514",449,1,1,2,0.5,0.5
"515",450,1,1,2,0.5,0.5
"516",451,1,1,2,0.5,0.5
"517",452,1,1,2,0.5,0.5
"518",453,1,1,2,0.5,0.5
"519",454,1,1,2,0.5,0.5
"520",455,1,1,2,0.5,0.5
"521",456,1,1,2,0.5,0.5
"522",457,1,1,2,0.5,0.5
"523",458,1,1,2,0.5,0.5
"524",459,1,1,2,0.5,0.5
"525",460,1,1,2,0.5,0.5
"526",461,1,1,2,0.5,0.5
"527",462,1,1,2,0.5,0.5
"528",463,1,1,2,0.5,0.5
"529",464,1,1,2,0.5,0.5
"530",465,1,1,2,0.5,0.5
"531",466,1,1,2,0.5,0.5
"532",467,1,1,2,0.5,0.5
"533",468,1,1,2,0.5,0.5
"534",469,1,1,2,0.5,0.5
"535",470,1,1,2,0.5,0.5
"536",471,1,1,2,0.5,0.5
"537",472,1,1,2,0.5,0.5
"538",473,1,1,2,0.5,0.5
"539",474,1,1,2,0.5,0.5
"540",475,1,1,2,0.5,0.5
"541",476,1,1,2,0.5,0.5
"542",477,1,1,2,0.5,0.5
"543",478,1,1,2,0.5,0.5
"544",479,1,1,2,0.5,0.5
"545",480,1,1,2,0.5,0.5
"546",481,1,1,2,0.5,0.5
"547",482,1,1,2,0.5,0.5
"548",483,1,1,2,0.5,0.5
"549",484,1,1,2,0.5,0.5
"550",485,1,1,2,0.5,0.5
"551",486,1,1,2,0.5,0.5
"552",487,1,1,2,0.5,0.5
"553",488,1,1,2,0.5,0.5
"554",489,1,1,2,0.5,0.5
"555",490,1,1,2,0.5,0.5
"556",491,1,1,2,0.5,0.5
"557",492,1,1,2,0.5,0.5
"558",493,1,1,2,0.5,0.5
"559",494,1,1,2,0.5,0.5
"560",495,1,1,2,0.5,0.5
"561",496,1,1,2,0.5,0.5
"562",497,1,1,2,0.5,0.5
"563",498,1,1,2,0.5,0.5
"564",499,1,1,2,0.5,0.5
"565",500,1,1,2,0.5,0.5
"566",501,1,1,2,0.5,0.5
"567",502,1,1,2,0.5,0.5
"568",503,1,1,2,0.5,0.5
"569",504,1,1,2,0.5,0.5
"570",505,1,1,2,0.5,0.5
"571",506,1,1,2,0.5,0.5
"572",507,1,1,2,0.5,0.5
"573",508,1,1,2,0.5,0.5
"574",509,1,1,2,0.5,0.5
"575",510,1,1,2,0.5,0.5
"576",511,1,1,2,0.5,0.5
"577",512,1,1,2,0.5,0.5
"578",513,1,1,2,0.5,0.5
"579",514,1,1,2,0.5,0.5
"580",515,1,1,2,0.5,0.5
"581",516,1,1,2,0.5,0.5
"582",517,1,1,2,0.5,0.5
"583",518,1,1,2,0.5,0.5
"584",519,1,1,2,0.5,0.5
"585",520,1,1,2,0.5,0.5
"586",521,1,1,2,0.5,0.5
"587",522,1,1,2,0.5,0.5
"588",523,1,1,2,0.5,0.5
"589",524,1,1,2,0.5,0.5
"590",525,1,1,2,0.5,0.5
"591",526,1,1,2,0.5,0.5
"592",527,1,1,2,0.5,0.5
"593",528,1,1,2,0.5,0.5
"594",529,1,1,2,0.5,0.5
"595",530,1,1,2,0.5,0.5
"596",531,1,1,2,0.5,0.5
"597",532,1,1,2,0.5,0.5
"598",533,1,1,2,0.5,0.5
"599",534,1,1,2,0.5,0.5
"600",535,1,1,2,0.5,0.5
"601",536,1,1,2,0.5,0.5
"602",537,1,1,2,0.5,0.5
"603",538,1,1,2,0.5,0.5
"604",539,1,1,2,0.5,0.5
"605",540,1,1,2,0.5,0.5
"606",541,1,1,2,0.5,0.5
"607",542,1,1,2,0.5,0.5
"608",543,1,1,2,0.5,0.5
"609",544,1,1,2,0.5,0.5
"610",545,1,1,2,0.5,0.5
"611",546,1,1,2,0.5,0.5
"612",547,1,1,2,0.5,0.5
"613",548,1,1,2,0.5,0.5
"614",549,1,1,2,0.5,0.5
"615",550,1,1,2,0.5,0.5
"616",551,1,1,2,0.5,0.5
"617",552,1,1,2,0.5,0.5
"618",553,1,1,2,0.5,0.5
"619",554,1,1,2,0.5,0.5
"620",555,1,1,2,0.5,0.5
"621",556,1,1,2,0.5,0.5
"622",557,1,1,2,0.5,0.5
"623",558,1,1,2,0.5,0.5
"624",559,1,1,2,0.5,0.5
"625",560,1,1,2,0.5,0.5
"626",561,1,1,2,0.5,0.5
"627",562,1,1,2,0.5,0.5
"628",563,1,1,2,0.5,0.5
"629",564,1,1,2,0.5,0.5
"630",565,1,1,2,0.5,0.5
"631",566,1,1,2,0.5,0.5
"632",567,1,1,2,0.5,0.5
"633",568,1,1,2,0.5,0.5
"634",569,1,1,2,0.5,0.5
"635",570,1,1,2,0.5,0.5
"636",571,1,1,2,0.5,0.5
"637",572,1,1,2,0.5,0.5
"638",573,1,1,2,0.5,0.5
"639",574,1,1,2,0.5,0.5
"640",575,1,1,2,0.5,0.5
"641",576,1,1,2,0.5,0.5
"642",577,1,1,2,0.5,0.5
"643",578,1,1,2,0.5,0.5
"644",579,1,1,2,0.5,0.5
"645",580,1,1,2,0.5,0.5
"646",581,1,1,2,0.5,0.5
"647",582,1,1,2,0.5,0.5
"648",583,1,1,2,0.5,0.5
"649",584,1,1,2,0.5,0.5
"650",585,1,1,2,0.5,0.5
"651",586,1,1,2,0.5,0.5
"652",587,1,1,2,0.5,0.5
"653",588,1,1,2,0.5,0.5
"654",589,1,1,2,0.5,0.5
"655",590,1,1,2,0.5,0.5
"656",591,1,1,2,0.5,0.5
"657",592,1,1,2,0.5,0.5
"658",593,1,1,2,0.5,0.5
"659",594,1,1,2,0.5,0.5
"660",595,1,1,2,0.5,0.5
"661",596,1,1,2,0.5,0.5
"662",597,1,1,2,0.5,0.5
"663",598,1,1,2,0.5,0.5
"664",599,1,1,2,0.5,0.5
"665",600,1,1,2,0.5,0.5
"666",601,1,1,2,0.5,0.5
"667",602,1,1,2,0.5,0.5
"668",603,1,1,2,0.5,0.5
"669",604,1,1,2,0.5,0.5
"670",605,1,1,2,0.5,0.5
"671",606,1,1,2,0.5,0.5
"672",607,1,1,2,0.5,0.5
"673",608,1,1,2,0.5,0.5
"674",609,1,1,2,0.5,0.5
"675",610,1,1,2,0.5,0.5
"676",611,1,1,2,0.5,0.5
"677",612,1,1,2,0.5,0.5
"678",613,1,1,2,0.5,0.5
"679",614,1,1,2,0.5,0.5
"680",615,1,1,2,0.5,0.5
"681",616,1,1,2,0.5,0.5
"682",617,1,1,2,0.5,0.5
"683",618,1,1,2,0.5,0.5
"684",619,1,1,2,0.5,0.5
"685",620,1,1,2,0.5,0.5
"686",621,1,1,2,0.5,0.5
"687",622,1,1,2,0.5,0.5
"688",623,1,1,2,0.5,0.5
"689",624,1,1,2,0.5,0.5
"690",625,1,1,2,0.5,0.5
"691",626,1,1,2,0.5,0.5
"692",627,1,1,2,0.5,0.5
"693",628,1,1,2,0.5,0.5
"694",629,1,1,2,0.5,0.5
"695",630,1,1,2,0.5,0.5
"696",631,1,1,2,0.5,0.5
"697",632,1,1,2,0.5,0.5
"698",633,1,1,2,0.5,0.5
"699",634,1,1,2,0.5,0.5
"700",635,1,1,2,0.5,0.5
"701",636,1,1,2,0.5,0.5
"702",637,1,1,2,0.5,0.5
"703",638,1,1,2,0.5,0.5
"704",639,1,1,2,0.5,0.5
"705",640,1,1,2,0.5,0.5
"706",641,1,1,2,0.5,0.5
"707",642,1,1,2,0.5,0.5
"708",643,1,1,2,0.5,0.5
"709",644,1,1,2,0.5,0.5
"710",645,1,1,2,0.5,0.5
"711",646,1,1,2,0.5,0.5
"712",647,1,1,2,0.5,0.5
"713",648,1,1,2,0.5,0.5
"714",649,1,1,2,0.5,0.5
"715",650,1,1,2,0.5,0.5
"716",651,1,1,2,0.5,0.5
"717",652,1,1,2,0.5,0.5
"718",653,1,1,2,0.5,0.5
"719",654,1,1,2,0.5,0.5
"720",655,1,1,2,0.5,0.5
"721",656,1,1,2,0.5,0.5
"722",657,1,1,2,0.5,0.5
"723",658,1,1,2,0.5,0.5
"724",659,1,1,2,0.5,0.5
"725",660,1,1,2,0.5,0.5
"726",661,1,1,2,0.5,0.5
"727",662,1,1,2,0.5,0.5
"728",663,1,1,2,0.5,0.5
"729",664,1,1,2,0.5,0.5
"730",665,1,1,2,0.5,0.5
"731",666,1,1,2,0.5,0.5
"732",667,1,1,2,0.5,0.5
"733",668,1,1,2,0.5,0.5
"734",669,1,1,2,0.5,0.5
"735",670,1,1,2,0.5,0.5
"736",671,1,1,2,0.5,0.5
"737",672,1,1,2,0.5,0.5
"738",673,1,1,2,0.5,0.5
"739",674,1,1,2,0.5,0.5
"740",675,1,1,2,0.5,0.5
"741",676,1,1,2,0.5,0.5
"742",677,1,1,2,0.5,0.5
"743",678,1,1,2,0.5,0.5
"744",679,1,1,2,0.5,0.5
"745",680,1,1,2,0.5,0.5
"746",681,1,1,2,0.5,0.5
"747",682,1,1,2,0.5,0.5
"748",683,1,1,2,0.5,0.5
"749",684,1,1,2,0.5,0.5
"750",685,1,1,2,0.5,0.5
"751",686,1,1,2,0.5,0.5
"752",687,1,1,2,0.5,0.5
"753",688,1,1,2,0.5,0.5
"754",689,1,1,2,0.5,0.5
"755",690,1,1,2,0.5,0.5
"756",691,1,1,2,0.5,0.5
"757",692,1,1,2,0.5,0.5
"758",693,1,1,2,0.5,0.5
"759",694,1,1,2,0.5,0.5
"760",695,1,1,2,0.5,0.5
"761",696,1,1,2,0.5,0.5
"762",697,1,1,2,0.5,0.5
"763",698,1,1,2,0.5,0.5
"764",699,1,1,2,0.5,0.5
"765",700,1,1,2,0.5,0.5
"766",701,1,1,2,0.5,0.5
"767",702,1,1,2,0.5,0.5
"768",703,1,1,2,0.5,0.5
"769",704,1,1,2,0.5,0.5
"770",705,1,1,2,0.5,0.5
"771",706,1,1,2,0.5,0.5
"772",707,1,1,2,0.5,0.5
"773",708,1,1,2,0.5,0.5
"774",709,1,1,2,0.5,0.5
"775",710,1,1,2,0.5,0.5
"776",711,1,1,2,0.5,0.5
"777",712,1,1,2,0.5,0.5
"778",713,1,1,2,0.5,0.5
"779",714,1,1,2,0.5,0.5
"780",715,1,1,2,0.5,0.5
"781",716,1,1,2,0.5,0.5
"782",717,1,1,2,0.5,0.5
"783",718,1,1,2,0.5,0.5
"784",719,1,1,2,0.5,0.5
"785",720,1,1,2,0.5,0.5
"786",721,1,1,2,0.5,0.5
"787",722,1,1,2,0.5,0.5
"788",723,1,1,2,0.5,0.5
"789",724,1,1,2,0.5,0.5
"790",725,1,1,2,0.5,0.5
"791",726,1,1,2,0.5,0.5
"792",727,1,1,2,0.5,0.5
"793",728,1,1,2,0.5,0.5
"794",729,1,1,2,0.5,0.5
"795",730,1,1,2,0.5,0.5
"796",731,1,1,2,0.5,0.5
"797",732,1,1,2,0.5,0.5
"798",733,1,1,2,0.5,0.5
"799",734,1,1,2,0.5,0.5
"800",735,1,1,2,0.5,0.5
"801",736,1,1,2,0.5,0.5
"802",737,1,1,2,0.5,0.5
"803",738,1,1,2,0.5,0.5
"804",739,1,1,2,0.5,0.5
"805",740,1,1,2,0.5,0.5
"806",741,1,1,2,0.5,0.5
"807",742,1,1,2,0.5,0.5
"808",743,1,1,2,0.5,0.5
"809",744,1,1,2,0.5,0.5
"810",745,1,1,2,0.5,0.5
"811",746,1,1,2,0.5,0.5
"812",747,1,1,2,0.5,0.5
"813",748,1,1,2,0.5,0.5
"814",749,1,1,2,0.5,0.5
"815",750,1,1,2,0.5,0.5
"816",751,1,1,2,0.5,0.5
"817",752,1,1,2,0.5,0.5
"818",753,1,1,2,0.5,0.5
"819",754,1,1,2,0.5,0.5
"820",755,1,1,2,0.5,0.5
"821",756,1,1,2,0.5,0.5
"822",757,1,1,2,0.5,0.5
"823",758,1,1,2,0.5,0.5
"824",759,1,1,2,0.5,0.5
"825",760,1,1,2,0.5,0.5
"826",761,1,1,2,0.5,0.5
"827",762,1,1,2,0.5,0.5
"828",763,1,1,2,0.5,0.5
"829",764,1,1,2,0.5,0.5
"830",765,1,1,2,0.5,0.5
"831",766,1,1,2,0.5,0.5
"832",767,1,1,2,0.5,0.5
"833",768,1,1,2,0.5,0.5
"834",769,1,1,2,0.5,0.5
"835",770,1,1,2,0.5,0.5
"836",771,1,1,2,0.5,0.5
"837",772,1,1,2,0.5,0.5
"838",773,1,1,2,0.5,0.5
"839",774,1,1,2,0.5,0.5
"840",775,1,1,2,0.5,0.5
"841",776,1,1,2,0.5,0.5
"842",777,1,1,2,0.5,0.5
"843",778,1,1,2,0.5,0.5
"844",779,1,1,2,0.5,0.5
"845",780,1,1,2,0.5,0.5
"846",781,1,1,2,0.5,0.5
"847",782,1,1,2,0.5,0.5
"848",783,1,1,2,0.5,0.5
"849",784,1,1,2,0.5,0.5
"850",785,1,1,2,0.5,0.5
"851",786,1,1,2,0.5,0.5
"852",787,1,1,2,0.5,0.5
"853",788,1,1,2,0.5,0.5
"854",789,1,1,2,0.5,0.5
"855",790,1,1,2,0.5,0.5
"856",791,1,1,2,0.5,0.5
"857",792,1,1,2,0.5,0.5
"858",793,1,1,2,0.5,0.5
"859",794,1,1,2,0.5,0.5
"860",795,1,1,2,0.5,0.5
"861",796,1,1,2,0.5,0.5
"862",797,1,1,2,0.5,0.5
"863",798,1,1,2,0.5,0.5
"864",799,1,1,2,0.5,0.5
"865",800,1,1,2,0.5,0.5
"866",801,1,1,2,0.5,0.5
"867",802,1,1,2,0.5,0.5
"868",803,1,1,2,0.5,0.5
"869",804,1,1,2,0.5,0.5
"870",805,1,1,2,0.5,0.5
"871",806,1,1,2,0.5,0.5
"872",807,1,1,2,0.5,0.5
"873",808,1,1,2,0.5,0.5
"874",809,1,1,2,0.5,0.5
"875",810,1,1,2,0.5,0.5
"876",811,1,1,2,0.5,0.5
"877",812,1,1,2,0.5,0.5
"878",813,1,1,2,0.5,0.5
"879",814,1,1,2,0.5,0.5
"880",815,1,1,2,0.5,0.5
"881",816,1,1,2,0.5,0.5
"882",817,1,1,2,0.5,0.5
"883",818,1,1,2,0.5,0.5
"884",819,1,1,2,0.5,0.5
"885",820,1,1,2,0.5,0.5
"886",821,1,1,2,0.5,0.5
"887",822,1,1,2,0.5,0.5
"888",823,1,1,2,0.5,0.5
"889",824,1,1,2,0.5,0.5
"890",825,1,1,2,0.5,0.5
"891",826,1,1,2,0.5,0.5
"892",827,1,1,2,0.5,0.5
"893",828,1,1,2,0.5,0.5
"894",829,1,1,2,0.5,0.5
"895",831,1,1,2,0.5,0.5
"896",832,1,1,2,0.5,0.5
"897",833,1,1,2,0.5,0.5
"898",834,1,1,2,0.5,0.5
"899",835,1,1,2,0.5,0.5
"900",836,1,1,2,0.5,0.5
"901",837,1,1,2,0.5,0.5
"902",838,1,1,2,0.5,0.5
"903",839,1,1,2,0.5,0.5
"904",840,1,1,2,0.5,0.5
"905",841,1,1,2,0.5,0.5
"906",842,1,1,2,0.5,0.5
"907",843,1,1,2,0.5,0.5
"908",844,1,1,2,0.5,0.5
"909",845,1,1,2,0.5,0.5
"910",846,1,1,2,0.5,0.5
"911",847,1,1,2,0.5,0.5
"912",848,1,1,2,0.5,0.5
"913",849,1,1,2,0.5,0.5
"914",850,1,1,2,0.5,0.5
"915",851,1,1,2,0.5,0.5
"916",852,1,1,2,0.5,0.5
"917",853,1,1,2,0.5,0.5
"918",854,1,1,2,0.5,0.5
"919",855,1,1,2,0.5,0.5
"920",856,1,1,2,0.5,0.5
"921",857,1,1,2,0.5,0.5
"922",858,1,1,2,0.5,0.5
"923",859,1,1,2,0.5,0.5
"924",860,1,1,2,0.5,0.5
"925",861,1,1,2,0.5,0.5
"926",862,1,1,2,0.5,0.5
"927",863,1,1,2,0.5,0.5
"928",864,1,1,2,0.5,0.5
"929",865,1,1,2,0.5,0.5
"930",866,1,1,2,0.5,0.5
"931",867,1,1,2,0.5,0.5
"932",868,1,1,2,0.5,0.5
"933",869,1,1,2,0.5,0.5
"934",870,1,1,2,0.5,0.5
"935",871,1,1,2,0.5,0.5
"936",872,1,1,2,0.5,0.5
"937",873,1,1,2,0.5,0.5
"938",874,1,1,2,0.5,0.5
"939",875,1,1,2,0.5,0.5
"940",876,1,1,2,0.5,0.5
"941",877,1,1,2,0.5,0.5
"942",878,1,1,2,0.5,0.5
"943",879,1,1,2,0.5,0.5
"944",880,1,1,2,0.5,0.5
"945",881,1,1,2,0.5,0.5
"946",882,1,1,2,0.5,0.5
"947",883,1,1,2,0.5,0.5
"948",884,1,1,2,0.5,0.5
"949",885,1,1,2,0.5,0.5
"950",886,1,1,2,0.5,0.5
"951",887,1,1,2,0.5,0.5
"952",888,1,1,2,0.5,0.5
"953",889,1,1,2,0.5,0.5
"954",890,1,1,2,0.5,0.5
"955",891,1,1,2,0.5,0.5
"956",892,1,1,2,0.5,0.5
"957",893,1,1,2,0.5,0.5
"958",894,1,1,2,0.5,0.5
"959",895,1,1,2,0.5,0.5
"960",896,1,1,2,0.5,0.5
"961",897,1,1,2,0.5,0.5
"962",898,1,1,2,0.5,0.5
"963",899,1,1,2,0.5,0.5
"964",900,1,1,2,0.5,0.5
"965",901,1,1,2,0.5,0.5
"966",902,1,1,2,0.5,0.5
"967",903,1,1,2,0.5,0.5
"968",904,1,1,2,0.5,0.5
"969",905,1,1,2,0.5,0.5
"970",906,1,1,2,0.5,0.5
"971",907,1,1,2,0.5,0.5
"972",908,1,1,2,0.5,0.5
"973",909,1,1,2,0.5,0.5
"974",910,1,1,2,0.5,0.5
"975",911,1,1,2,0.5,0.5
"976",912,1,1,2,0.5,0.5
"977",913,1,1,2,0.5,0.5
"978",914,1,1,2,0.5,0.5
"979",915,1,1,2,0.5,0.5
"980",916,1,1,2,0.5,0.5
"981",917,1,1,2,0.5,0.5
"982",918,1,1,2,0.5,0.5
"983",919,1,1,2,0.5,0.5
"984",920,1,1,2,0.5,0.5
"985",921,1,1,2,0.5,0.5
"986",922,1,1,2,0.5,0.5
"987",923,1,1,2,0.5,0.5
"988",924,1,1,2,0.5,0.5
"989",925,1,1,2,0.5,0.5
"990",926,1,1,2,0.5,0.5
"991",927,1,1,2,0.5,0.5
"992",928,1,1,2,0.5,0.5
"993",929,1,1,2,0.5,0.5
"994",930,1,1,2,0.5,0.5
"995",931,1,1,2,0.5,0.5
"996",932,1,1,2,0.5,0.5
"997",933,1,1,2,0.5,0.5
"998",934,1,1,2,0.5,0.5
"999",935,1,1,2,0.5,0.5
"1000",936,1,1,2,0.5,0.5
"1001",937,1,1,2,0.5,0.5
"1002",938,1,1,2,0.5,0.5
"1003",939,1,1,2,0.5,0.5
"1004",940,1,1,2,0.5,0.5
"1005",941,1,1,2,0.5,0.5
"1006",942,1,1,2,0.5,0.5
"1007",943,1,1,2,0.5,0.5
"1008",944,1,1,2,0.5,0.5
"1009",945,1,1,2,0.5,0.5
"1010",946,1,1,2,0.5,0.5
"1011",947,1,1,2,0.5,0.5
"1012",948,1,1,2,0.5,0.5
"1013",949,1,1,2,0.5,0.5
"1014",950,1,1,2,0.5,0.5
"1015",951,1,1,2,0.5,0.5
"1016",952,1,1,2,0.5,0.5
"1017",953,1,1,2,0.5,0.5
"1018",954,1,1,2,0.5,0.5
"1019",955,1,1,2,0.5,0.5
"1020",956,1,1,2,0.5,0.5
"1021",957,1,1,2,0.5,0.5
"1022",958,1,1,2,0.5,0.5
"1023",959,1,1,2,0.5,0.5
"1024",960,1,1,2,0.5,0.5
"1025",961,1,1,2,0.5,0.5
"1026",962,1,1,2,0.5,0.5
"1027",963,1,1,2,0.5,0.5
"1028",964,1,1,2,0.5,0.5
"1029",965,1,1,2,0.5,0.5
"1030",966,1,1,2,0.5,0.5
"1031",967,1,1,2,0.5,0.5
"1032",968,1,1,2,0.5,0.5
"1033",969,1,1,2,0.5,0.5
"1034",970,1,1,2,0.5,0.5
"1035",971,1,1,2,0.5,0.5
"1036",972,1,1,2,0.5,0.5
"1037",973,1,1,2,0.5,0.5
"1038",974,1,1,2,0.5,0.5
"1039",975,1,1,2,0.5,0.5
"1040",976,1,1,2,0.5,0.5
"1041",977,1,1,2,0.5,0.5
"1042",978,1,1,2,0.5,0.5
"1043",979,1,1,2,0.5,0.5
"1044",980,1,1,2,0.5,0.5
"1045",981,1,1,2,0.5,0.5
"1046",982,1,1,2,0.5,0.5
"1047",983,1,1,2,0.5,0.5
"1048",984,1,1,2,0.5,0.5
"1049",985,1,1,2,0.5,0.5
"1050",986,1,1,2,0.5,0.5
"1051",987,1,1,2,0.5,0.5
"1052",988,1,1,2,0.5,0.5
"1053",989,1,1,2,0.5,0.5
"1054",990,1,1,2,0.5,0.5
"1055",991,1,1,2,0.5,0.5
"1056",992,1,1,2,0.5,0.5
"1057",993,1,1,2,0.5,0.5
"1058",994,1,1,2,0.5,0.5
"1059",995,1,1,2,0.5,0.5
"1060",996,1,1,2,0.5,0.5
"1061",997,1,1,2,0.5,0.5
"1062",998,1,1,2,0.5,0.5
"1063",999,1,1,2,0.5,0.5
"1064",1000,1,1,2,0.5,0.5
"1065",1001,1,1,2,0.5,0.5
"1066",1002,1,1,2,0.5,0.5
"1067",1003,1,1,2,0.5,0.5
"1068",1004,1,1,2,0.5,0.5
"1069",1005,1,1,2,0.5,0.5
"1070",1006,1,1,2,0.5,0.5
"1071",1007,1,1,2,0.5,0.5
"1072",1008,1,1,2,0.5,0.5
"1073",1009,1,1,2,0.5,0.5
"1074",1010,1,1,2,0.5,0.5
"1075",1011,1,1,2,0.5,0.5
"1076",1012,1,1,2,0.5,0.5
"1077",1013,1,1,2,0.5,0.5
"1078",1014,1,1,2,0.5,0.5
"1079",1015,1,1,2,0.5,0.5
"1080",1016,1,1,2,0.5,0.5
"1081",1017,1,1,2,0.5,0.5
"1082",1018,1,1,2,0.5,0.5
"1083",1019,1,1,2,0.5,0.5
"1084",1020,1,1,2,0.5,0.5
"1085",1021,1,1,2,0.5,0.5
"1086",1022,1,1,2,0.5,0.5
"1087",1023,1,1,2,0.5,0.5
"1088",1024,1,1,2,0.5,0.5
"1089",1025,1,1,2,0.5,0.5
"1090",1026,1,1,2,0.5,0.5
"1091",1027,1,1,2,0.5,0.5
"1092",1028,1,1,2,0.5,0.5
"1093",1029,1,1,2,0.5,0.5
"1094",1030,1,1,2,0.5,0.5
"1095",1031,1,1,2,0.5,0.5
"1096",1032,1,1,2,0.5,0.5
"1097",1033,1,1,2,0.5,0.5
"1098",1034,1,1,2,0.5,0.5
"1099",1035,1,1,2,0.5,0.5
"1100",1036,1,1,2,0.5,0.5
"1101",1037,1,1,2,0.5,0.5
"1102",1038,1,1,2,0.5,0.5
"1103",1039,1,1,2,0.5,0.5
"1104",1040,1,1,2,0.5,0.5
"1105",1041,1,1,2,0.5,0.5
"1106",1042,1,1,2,0.5,0.5
"1107",1043,1,1,2,0.5,0.5
"1108",1044,1,1,2,0.5,0.5
"1109",1045,1,1,2,0.5,0.5
"1110",1046,1,1,2,0.5,0.5
"1111",1047,1,1,2,0.5,0.5
"1112",1048,1,1,2,0.5,0.5
"1113",1049,1,1,2,0.5,0.5
"1114",1050,1,1,2,0.5,0.5
"1115",1051,1,1,2,0.5,0.5
"1116",1052,1,1,2,0.5,0.5
"1117",1053,1,1,2,0.5,0.5
"1118",1054,1,1,2,0.5,0.5
"1119",1055,1,1,2,0.5,0.5
"1120",1056,1,1,2,0.5,0.5
"1121",1057,1,1,2,0.5,0.5
"1122",1058,1,1,2,0.5,0.5
"1123",1059,1,1,2,0.5,0.5
"1124",1060,1,1,2,0.5,0.5
"1125",1061,1,1,2,0.5,0.5
"1126",1062,1,1,2,0.5,0.5
"1127",1063,1,1,2,0.5,0.5
"1128",1064,1,1,2,0.5,0.5
"1129",1065,1,1,2,0.5,0.5
"1130",1066,1,1,2,0.5,0.5
"1131",1067,1,1,2,0.5,0.5
"1132",1068,1,1,2,0.5,0.5
"1133",1069,1,1,2,0.5,0.5
"1134",1070,1,1,2,0.5,0.5
"1135",1071,1,1,2,0.5,0.5
"1136",1072,1,1,2,0.5,0.5
"1137",1073,1,1,2,0.5,0.5
"1138",1074,1,1,2,0.5,0.5
"1139",1075,1,1,2,0.5,0.5
"1140",1076,1,1,2,0.5,0.5
"1141",1077,1,1,2,0.5,0.5
"1142",1078,1,1,2,0.5,0.5
"1143",1079,1,1,2,0.5,0.5
"1144",1080,1,1,2,0.5,0.5
"1145",1081,1,1,2,0.5,0.5
"1146",1082,1,1,2,0.5,0.5
"1147",1083,1,1,2,0.5,0.5
"1148",1084,1,1,2,0.5,0.5
"1149",1085,1,1,2,0.5,0.5
"1150",1086,1,1,2,0.5,0.5
"1151",1087,1,1,2,0.5,0.5
"1152",1088,1,1,2,0.5,0.5
"1153",1089,1,1,2,0.5,0.5
"1154",1091,1,1,2,0.5,0.5
"1155",1092,1,1,2,0.5,0.5
"1156",1093,1,1,2,0.5,0.5
"1157",1094,1,1,2,0.5,0.5
"1158",1095,1,1,2,0.5,0.5
"1159",1096,1,1,2,0.5,0.5
"1160",1097,1,1,2,0.5,0.5
"1161",1098,1,1,2,0.5,0.5
"1162",1099,1,1,2,0.5,0.5
"1163",1100,1,1,2,0.5,0.5
"1164",1101,1,1,2,0.5,0.5
"1165",1102,1,1,2,0.5,0.5
"1166",1103,1,1,2,0.5,0.5
"1167",1104,1,1,2,0.5,0.5
"1168",1105,1,1,2,0.5,0.5
"1169",1106,1,1,2,0.5,0.5
"1170",1107,1,1,2,0.5,0.5
"1171",1108,1,1,2,0.5,0.5
"1172",1109,1,1,2,0.5,0.5
"1173",1110,1,1,2,0.5,0.5
"1174",1111,1,1,2,0.5,0.5
"1175",1112,1,1,2,0.5,0.5
"1176",1113,1,1,2,0.5,0.5
"1177",1114,1,1,2,0.5,0.5
"1178",1115,1,1,2,0.5,0.5
"1179",1116,1,1,2,0.5,0.5
"1180",1117,1,1,2,0.5,0.5
"1181",1118,1,1,2,0.5,0.5
"1182",1119,1,1,2,0.5,0.5
"1183",1120,1,1,2,0.5,0.5
"1184",1121,1,1,2,0.5,0.5
"1185",1122,1,1,2,0.5,0.5
"1186",1123,1,1,2,0.5,0.5
"1187",1124,1,1,2,0.5,0.5
"1188",1125,1,1,2,0.5,0.5
"1189",1126,1,1,2,0.5,0.5
"1190",1127,1,1,2,0.5,0.5
"1191",1128,1,1,2,0.5,0.5
"1192",1129,1,1,2,0.5,0.5
"1193",1130,1,1,2,0.5,0.5
"1194",1131,1,1,2,0.5,0.5
"1195",1132,1,1,2,0.5,0.5
"1196",1133,1,1,2,0.5,0.5
"1197",1134,1,1,2,0.5,0.5
"1198",1135,1,1,2,0.5,0.5
"1199",1136,1,1,2,0.5,0.5
"1200",1137,1,1,2,0.5,0.5
"1201",1138,1,1,2,0.5,0.5
"1202",1139,1,1,2,0.5,0.5
"1203",1140,1,1,2,0.5,0.5
"1204",1141,1,1,2,0.5,0.5
"1205",1142,1,1,2,0.5,0.5
"1206",1143,1,1,2,0.5,0.5
"1207",1144,1,1,2,0.5,0.5
"1208",1145,1,1,2,0.5,0.5
"1209",1146,1,1,2,0.5,0.5
"1210",1147,1,1,2,0.5,0.5
"1211",1148,1,1,2,0.5,0.5
"1212",1149,1,1,2,0.5,0.5
"1213",1150,1,1,2,0.5,0.5
"1214",1151,1,1,2,0.5,0.5
"1215",1152,1,1,2,0.5,0.5
"1216",1153,1,1,2,0.5,0.5
"1217",1154,1,1,2,0.5,0.5
"1218",1155,1,1,2,0.5,0.5
"1219",1156,1,1,2,0.5,0.5
"1220",1157,1,1,2,0.5,0.5
"1221",1158,1,1,2,0.5,0.5
"1222",1159,1,1,2,0.5,0.5
"1223",1160,1,1,2,0.5,0.5
"1224",1161,1,1,2,0.5,0.5
"1225",1162,1,1,2,0.5,0.5
"1226",1163,1,1,2,0.5,0.5
"1227",1164,1,1,2,0.5,0.5
"1228",1165,1,1,2,0.5,0.5
"1229",1166,1,1,2,0.5,0.5
"1230",1167,1,1,2,0.5,0.5
"1231",1168,1,1,2,0.5,0.5
"1232",1169,1,1,2,0.5,0.5
"1233",1170,1,1,2,0.5,0.5
"1234",1171,1,1,2,0.5,0.5
"1235",1172,1,1,2,0.5,0.5
"1236",1173,1,1,2,0.5,0.5
"1237",1174,1,1,2,0.5,0.5
"1238",1175,1,1,2,0.5,0.5
"1239",1176,1,1,2,0.5,0.5
"1240",1177,1,1,2,0.5,0.5
"1241",1178,1,1,2,0.5,0.5
"1242",1179,1,1,2,0.5,0.5
"1243",1180,1,1,2,0.5,0.5
"1244",1181,1,1,2,0.5,0.5
"1245",1182,1,1,2,0.5,0.5
"1246",1183,1,1,2,0.5,0.5
"1247",1184,1,1,2,0.5,0.5
"1248",1185,1,1,2,0.5,0.5
"1249",1186,1,1,2,0.5,0.5
"1250",1187,1,1,2,0.5,0.5
"1251",1188,1,1,2,0.5,0.5
"1252",1189,1,1,2,0.5,0.5
"1253",1190,1,1,2,0.5,0.5
"1254",1191,1,1,2,0.5,0.5
"1255",1192,1,1,2,0.5,0.5
"1256",1195,1,1,2,0.5,0.5
"1257",1196,1,1,2,0.5,0.5
"1258",1197,1,1,2,0.5,0.5
"1259",1198,1,1,2,0.5,0.5
"1260",1199,1,1,2,0.5,0.5
"1261",1200,1,1,2,0.5,0.5
"1262",1201,1,1,2,0.5,0.5
"1263",1202,1,1,2,0.5,0.5
"1264",1203,1,1,2,0.5,0.5
"1265",1204,1,1,2,0.5,0.5
"1266",1205,1,1,2,0.5,0.5
"1267",1206,1,1,2,0.5,0.5
"1268",1207,1,1,2,0.5,0.5
"1269",1208,1,1,2,0.5,0.5
"1270",1209,1,1,2,0.5,0.5
"1271",1210,1,1,2,0.5,0.5
"1272",1211,1,1,2,0.5,0.5
"1273",1212,1,1,2,0.5,0.5
"1274",1213,1,1,2,0.5,0.5
"1275",1214,1,1,2,0.5,0.5
"1276",1215,1,1,2,0.5,0.5
"1277",1216,1,1,2,0.5,0.5
"1278",1217,1,1,2,0.5,0.5
"1279",1218,1,1,2,0.5,0.5
"1280",1219,1,1,2,0.5,0.5
"1281",1220,1,1,2,0.5,0.5
"1282",1221,1,1,2,0.5,0.5
"1283",1222,1,1,2,0.5,0.5
"1284",1223,1,1,2,0.5,0.5
"1285",1224,1,1,2,0.5,0.5
"1286",1226,1,1,2,0.5,0.5
"1287",1227,1,1,2,0.5,0.5
"1288",1228,1,1,2,0.5,0.5
"1289",1229,1,1,2,0.5,0.5
"1290",1230,1,1,2,0.5,0.5
"1291",1231,1,1,2,0.5,0.5
"1292",1232,1,1,2,0.5,0.5
"1293",1233,1,1,2,0.5,0.5
"1294",1234,1,1,2,0.5,0.5
"1295",1235,1,1,2,0.5,0.5
"1296",1236,1,1,2,0.5,0.5
"1297",1237,1,1,2,0.5,0.5
"1298",1238,1,1,2,0.5,0.5
"1299",1239,1,1,2,0.5,0.5
"1300",1240,1,1,2,0.5,0.5
"1301",1241,1,1,2,0.5,0.5
"1302",1242,1,1,2,0.5,0.5
"1303",1243,1,1,2,0.5,0.5
"1304",1244,1,1,2,0.5,0.5
"1305",1245,1,1,2,0.5,0.5
"1306",1246,1,1,2,0.5,0.5
"1307",1247,1,1,2,0.5,0.5
"1308",1248,1,1,2,0.5,0.5
"1309",1249,1,1,2,0.5,0.5
"1310",1250,1,1,2,0.5,0.5
"1311",1251,1,1,2,0.5,0.5
"1312",1252,1,1,2,0.5,0.5
"1313",1253,1,1,2,0.5,0.5
"1314",1254,1,1,2,0.5,0.5
"1315",1255,1,1,2,0.5,0.5
"1316",1256,1,1,2,0.5,0.5
"1317",1257,1,1,2,0.5,0.5
"1318",1258,1,1,2,0.5,0.5
"1319",1259,1,1,2,0.5,0.5
"1320",1260,1,1,2,0.5,0.5
"1321",1261,1,1,2,0.5,0.5
"1322",1262,1,1,2,0.5,0.5
"1323",1263,1,1,2,0.5,0.5
"1324",1264,1,1,2,0.5,0.5
"1325",1265,1,1,2,0.5,0.5
"1326",1266,1,1,2,0.5,0.5
"1327",1267,1,1,2,0.5,0.5
"1328",1268,1,1,2,0.5,0.5
"1329",1269,1,1,2,0.5,0.5
"1330",1270,1,1,2,0.5,0.5
"1331",1271,1,1,2,0.5,0.5
"1332",1272,1,1,2,0.5,0.5
"1333",1273,1,1,2,0.5,0.5
"1334",1274,1,1,2,0.5,0.5
"1335",1275,1,1,2,0.5,0.5
"1336",1276,1,1,2,0.5,0.5
"1337",1277,1,1,2,0.5,0.5
"1338",1278,1,1,2,0.5,0.5
"1339",1279,1,1,2,0.5,0.5
"1340",1280,1,1,2,0.5,0.5
"1341",1281,1,1,2,0.5,0.5
"1342",1282,1,1,2,0.5,0.5
"1343",1283,1,1,2,0.5,0.5
"1344",1284,1,1,2,0.5,0.5
"1345",1285,1,1,2,0.5,0.5
"1346",1286,1,1,2,0.5,0.5
"1347",1287,1,1,2,0.5,0.5
"1348",1288,1,1,2,0.5,0.5
"1349",1289,1,1,2,0.5,0.5
"1350",1290,1,1,2,0.5,0.5
"1351",1291,1,1,2,0.5,0.5
"1352",1292,1,1,2,0.5,0.5
"1353",1293,1,1,2,0.5,0.5
"1354",1294,1,1,2,0.5,0.5
"1355",1295,1,1,2,0.5,0.5
"1356",1296,1,1,2,0.5,0.5
"1357",1297,1,1,2,0.5,0.5
"1358",1298,1,1,2,0.5,0.5
"1359",1299,1,1,2,0.5,0.5
"1360",1300,1,1,2,0.5,0.5
"1361",1301,1,1,2,0.5,0.5
"1362",1302,1,1,2,0.5,0.5
"1363",1303,1,1,2,0.5,0.5
"1364",1304,1,1,2,0.5,0.5
"1365",1305,1,1,2,0.5,0.5
"1366",1306,1,1,2,0.5,0.5
"1367",1307,1,1,2,0.5,0.5
"1368",1308,1,1,2,0.5,0.5
"1369",1309,1,1,2,0.5,0.5
"1370",1310,1,1,2,0.5,0.5
"1371",1311,1,1,2,0.5,0.5
"1372",1312,1,1,2,0.5,0.5
"1373",1313,1,1,2,0.5,0.5
"1374",1314,1,1,2,0.5,0.5
"1375",1315,1,1,2,0.5,0.5
"1376",1317,1,1,2,0.5,0.5
"1377",1318,1,1,2,0.5,0.5
"1378",1319,1,1,2,0.5,0.5
"1379",1320,1,1,2,0.5,0.5
"1380",1321,1,1,2,0.5,0.5
"1381",1322,1,1,2,0.5,0.5
"1382",1323,1,1,2,0.5,0.5
"1383",1324,1,1,2,0.5,0.5
"1384",1325,1,1,2,0.5,0.5
"1385",1326,1,1,2,0.5,0.5
"1386",1327,1,1,2,0.5,0.5
"1387",1328,1,1,2,0.5,0.5
"1388",1329,1,1,2,0.5,0.5
"1389",1330,1,1,2,0.5,0.5
"1390",1331,1,1,2,0.5,0.5
"1391",1332,1,1,2,0.5,0.5
"1392",1333,1,1,2,0.5,0.5
"1393",1334,1,1,2,0.5,0.5
"1394",1335,1,1,2,0.5,0.5
"1395",1336,1,1,2,0.5,0.5
"1396",1337,1,1,2,0.5,0.5
"1397",1338,1,1,2,0.5,0.5
"1398",1339,1,1,2,0.5,0.5
"1399",1340,1,1,2,0.5,0.5
"1400",1341,1,1,2,0.5,0.5
"1401",1342,1,1,2,0.5,0.5
"1402",1343,1,1,2,0.5,0.5
"1403",1344,1,1,2,0.5,0.5
"1404",1345,1,1,2,0.5,0.5
"1405",1346,1,1,2,0.5,0.5
"1406",1347,1,1,2,0.5,0.5
"1407",1348,1,1,2,0.5,0.5
"1408",1349,1,1,2,0.5,0.5
"1409",1350,1,1,2,0.5,0.5
"1410",1351,1,1,2,0.5,0.5
"1411",1352,1,1,2,0.5,0.5
"1412",1353,1,1,2,0.5,0.5
"1413",1354,1,1,2,0.5,0.5
"1414",1355,1,1,2,0.5,0.5
"1415",1356,1,1,2,0.5,0.5
"1416",1357,1,1,2,0.5,0.5
"1417",1358,1,1,2,0.5,0.5
"1418",1359,1,1,2,0.5,0.5
"1419",1360,1,1,2,0.5,0.5
"1420",1361,1,1,2,0.5,0.5
"1421",1362,1,1,2,0.5,0.5
"1422",1363,1,1,2,0.5,0.5
"1423",1364,1,1,2,0.5,0.5
"1424",1365,1,1,2,0.5,0.5
"1425",1366,1,1,2,0.5,0.5
"1426",1367,1,1,2,0.5,0.5
"1427",1368,1,1,2,0.5,0.5
"1428",1369,1,1,2,0.5,0.5
"1429",1370,1,1,2,0.5,0.5
"1430",1371,1,1,2,0.5,0.5
"1431",1372,1,1,2,0.5,0.5
"1432",1373,1,1,2,0.5,0.5
"1433",1374,1,1,2,0.5,0.5
"1434",1375,1,1,2,0.5,0.5
"1435",1376,1,1,2,0.5,0.5
"1436",1377,1,1,2,0.5,0.5
"1437",1378,1,1,2,0.5,0.5
"1438",1379,1,1,2,0.5,0.5
"1439",1380,1,1,2,0.5,0.5
"1440",1381,1,1,2,0.5,0.5
"1441",1382,1,1,2,0.5,0.5
"1442",1383,1,1,2,0.5,0.5
"1443",1384,1,1,2,0.5,0.5
"1444",1385,1,1,2,0.5,0.5
"1445",1386,1,1,2,0.5,0.5
"1446",1387,1,1,2,0.5,0.5
"1447",1388,1,1,2,0.5,0.5
"1448",1389,1,1,2,0.5,0.5
"1449",1390,1,1,2,0.5,0.5
"1450",1391,1,1,2,0.5,0.5
"1451",1392,1,1,2,0.5,0.5
"1452",1393,1,1,2,0.5,0.5
"1453",1394,1,1,2,0.5,0.5
"1454",1395,1,1,2,0.5,0.5
"1455",1396,1,1,2,0.5,0.5
"1456",1397,1,1,2,0.5,0.5
"1457",1398,1,1,2,0.5,0.5
"1458",1399,1,1,2,0.5,0.5
"1459",1400,1,1,2,0.5,0.5
"1460",1401,1,1,2,0.5,0.5
"1461",1402,1,1,2,0.5,0.5
"1462",1403,1,1,2,0.5,0.5
"1463",1404,1,1,2,0.5,0.5
"1464",1405,1,1,2,0.5,0.5
"1465",1406,1,1,2,0.5,0.5
"1466",1407,1,1,2,0.5,0.5
"1467",1408,1,1,2,0.5,0.5
"1468",1409,1,1,2,0.5,0.5
"1469",1410,1,1,2,0.5,0.5
"1470",1411,1,1,2,0.5,0.5
"1471",1412,1,1,2,0.5,0.5
"1472",1413,1,1,2,0.5,0.5
"1473",1414,1,1,2,0.5,0.5
"1474",1415,1,1,2,0.5,0.5
"1475",1416,1,1,2,0.5,0.5
"1476",1417,1,1,2,0.5,0.5
"1477",1418,1,1,2,0.5,0.5
"1478",1419,1,1,2,0.5,0.5
"1479",1420,1,1,2,0.5,0.5
"1480",1421,1,1,2,0.5,0.5
"1481",1422,1,1,2,0.5,0.5
"1482",1423,1,1,2,0.5,0.5
"1483",1424,1,1,2,0.5,0.5
"1484",1425,1,1,2,0.5,0.5
"1485",1426,1,1,2,0.5,0.5
"1486",1427,1,1,2,0.5,0.5
"1487",1428,1,1,2,0.5,0.5
"1488",1429,1,1,2,0.5,0.5
"1489",1430,1,1,2,0.5,0.5
"1490",1431,1,1,2,0.5,0.5
"1491",1432,1,1,2,0.5,0.5
"1492",1433,1,1,2,0.5,0.5
"1493",1434,1,1,2,0.5,0.5
"1494",1435,1,1,2,0.5,0.5
"1495",1436,1,1,2,0.5,0.5
"1496",1437,1,1,2,0.5,0.5
"1497",1438,1,1,2,0.5,0.5
"1498",1439,1,1,2,0.5,0.5
"1499",1440,1,1,2,0.5,0.5
"1500",1441,1,1,2,0.5,0.5
"1501",1442,1,1,2,0.5,0.5
"1502",1443,1,1,2,0.5,0.5
"1503",1444,1,1,2,0.5,0.5
"1504",1445,1,1,2,0.5,0.5
"1505",1446,1,1,2,0.5,0.5
"1506",1447,1,1,2,0.5,0.5
"1507",1448,1,1,2,0.5,0.5
"1508",1449,1,1,2,0.5,0.5
"1509",1450,1,1,2,0.5,0.5
"1510",1451,1,1,2,0.5,0.5
"1511",1452,1,1,2,0.5,0.5
"1512",1453,1,1,2,0.5,0.5
"1513",1454,1,1,2,0.5,0.5
"1514",1455,1,1,2,0.5,0.5
"1515",1456,1,1,2,0.5,0.5
"1516",1457,1,1,2,0.5,0.5
"1517",1458,1,1,2,0.5,0.5
"1518",1459,1,1,2,0.5,0.5
"1519",1460,1,1,2,0.5,0.5
"1520",1461,1,1,2,0.5,0.5
"1521",1462,1,1,2,0.5,0.5
"1522",1463,1,1,2,0.5,0.5
"1523",1464,1,1,2,0.5,0.5
"1524",1465,1,1,2,0.5,0.5
"1525",1466,1,1,2,0.5,0.5
"1526",1467,1,1,2,0.5,0.5
"1527",1468,1,1,2,0.5,0.5
"1528",1469,1,1,2,0.5,0.5
"1529",1470,1,1,2,0.5,0.5
"1530",1471,1,1,2,0.5,0.5
"1531",1472,1,1,2,0.5,0.5
"1532",1473,1,1,2,0.5,0.5
"1533",1474,1,1,2,0.5,0.5
"1534",1475,1,1,2,0.5,0.5
"1535",1476,1,1,2,0.5,0.5
"1536",1477,1,1,2,0.5,0.5
"1537",1478,1,1,2,0.5,0.5
"1538",1479,1,1,2,0.5,0.5
"1539",1480,1,1,2,0.5,0.5
"1540",1481,1,1,2,0.5,0.5
"1541",1482,1,1,2,0.5,0.5
"1542",1483,1,1,2,0.5,0.5
"1543",1484,1,1,2,0.5,0.5
"1544",1485,1,1,2,0.5,0.5
"1545",1486,1,1,2,0.5,0.5
"1546",1487,1,1,2,0.5,0.5
"1547",1488,1,1,2,0.5,0.5
"1548",1489,1,1,2,0.5,0.5
"1549",1490,1,1,2,0.5,0.5
"1550",1491,1,1,2,0.5,0.5
"1551",1492,1,1,2,0.5,0.5
"1552",1493,1,1,2,0.5,0.5
"1553",1494,1,1,2,0.5,0.5
"1554",1495,1,1,2,0.5,0.5
"1555",1496,1,1,2,0.5,0.5
"1556",1497,1,1,2,0.5,0.5
"1557",1498,1,1,2,0.5,0.5
"1558",1499,1,1,2,0.5,0.5
"1559",1500,1,1,2,0.5,0.5
"1560",1501,1,1,2,0.5,0.5
"1561",1502,1,1,2,0.5,0.5
"1562",1503,1,1,2,0.5,0.5
"1563",1504,1,1,2,0.5,0.5
"1564",1505,1,1,2,0.5,0.5
"1565",1506,1,1,2,0.5,0.5
"1566",1507,1,1,2,0.5,0.5
"1567",1508,1,1,2,0.5,0.5
"1568",1509,1,1,2,0.5,0.5
"1569",1510,1,1,2,0.5,0.5
"1570",1511,1,1,2,0.5,0.5
"1571",1512,1,1,2,0.5,0.5
"1572",1513,1,1,2,0.5,0.5
"1573",1514,1,1,2,0.5,0.5
"1574",1515,1,1,2,0.5,0.5
"1575",1516,1,1,2,0.5,0.5
"1576",1517,1,1,2,0.5,0.5
"1577",1518,1,1,2,0.5,0.5
"1578",1519,1,1,2,0.5,0.5
"1579",1520,1,1,2,0.5,0.5
"1580",1521,1,1,2,0.5,0.5
"1581",1522,1,1,2,0.5,0.5
"1582",1523,1,1,2,0.5,0.5
"1583",1524,1,1,2,0.5,0.5
"1584",1525,1,1,2,0.5,0.5
"1585",1526,1,1,2,0.5,0.5
"1586",1527,1,1,2,0.5,0.5
"1587",1528,1,1,2,0.5,0.5
"1588",1529,1,1,2,0.5,0.5
"1589",1530,1,1,2,0.5,0.5
"1590",1531,1,1,2,0.5,0.5
"1591",1532,1,1,2,0.5,0.5
"1592",1533,1,1,2,0.5,0.5
"1593",1534,1,1,2,0.5,0.5
"1594",1535,1,1,2,0.5,0.5
"1595",1536,1,1,2,0.5,0.5
"1596",1537,1,1,2,0.5,0.5
"1597",1538,1,1,2,0.5,0.5
"1598",1539,1,1,2,0.5,0.5
"1599",1540,1,1,2,0.5,0.5
"1600",1541,1,1,2,0.5,0.5
"1601",1542,1,1,2,0.5,0.5
"1602",1543,1,1,2,0.5,0.5
"1603",1544,1,1,2,0.5,0.5
"1604",1545,1,1,2,0.5,0.5
"1605",1546,1,1,2,0.5,0.5
"1606",1547,1,1,2,0.5,0.5
"1607",1548,1,1,2,0.5,0.5
"1608",1549,1,1,2,0.5,0.5
"1609",1550,1,1,2,0.5,0.5
"1610",1551,1,1,2,0.5,0.5
"1611",1552,1,1,2,0.5,0.5
"1612",1553,1,1,2,0.5,0.5
"1613",1554,1,1,2,0.5,0.5
"1614",1555,1,1,2,0.5,0.5
"1615",1556,1,1,2,0.5,0.5
"1616",1557,1,1,2,0.5,0.5
"1617",1558,1,1,2,0.5,0.5
"1618",1559,1,1,2,0.5,0.5
"1619",1560,1,1,2,0.5,0.5
"1620",1561,1,1,2,0.5,0.5
"1621",1562,1,1,2,0.5,0.5
"1622",1563,1,1,2,0.5,0.5
"1623",1564,1,1,2,0.5,0.5
"1624",1565,1,1,2,0.5,0.5
"1625",1566,1,1,2,0.5,0.5
"1626",1567,1,1,2,0.5,0.5
"1627",1568,1,1,2,0.5,0.5
"1628",1569,1,1,2,0.5,0.5
"1629",1570,1,1,2,0.5,0.5
"1630",1571,1,1,2,0.5,0.5
"1631",1572,1,1,2,0.5,0.5
"1632",1573,1,1,2,0.5,0.5
"1633",1574,1,1,2,0.5,0.5
"1634",1575,1,1,2,0.5,0.5
"1635",1576,1,1,2,0.5,0.5
"1636",1577,1,1,2,0.5,0.5
"1637",1578,1,1,2,0.5,0.5
"1638",1579,1,1,2,0.5,0.5
"1639",1580,1,1,2,0.5,0.5
"1640",1581,1,1,2,0.5,0.5
"1641",1582,1,1,2,0.5,0.5
"1642",1583,1,1,2,0.5,0.5
"1643",1584,1,1,2,0.5,0.5
"1644",1585,1,1,2,0.5,0.5
"1645",1586,1,1,2,0.5,0.5
"1646",1587,1,1,2,0.5,0.5
"1647",1588,1,1,2,0.5,0.5
"1648",1589,1,1,2,0.5,0.5
"1649",1590,1,1,2,0.5,0.5
"1650",1591,1,1,2,0.5,0.5
"1651",1592,1,1,2,0.5,0.5
"1652",1593,1,1,2,0.5,0.5
"1653",1594,1,1,2,0.5,0.5
"1654",1595,1,1,2,0.5,0.5
"1655",1596,1,1,2,0.5,0.5
"1656",1597,1,1,2,0.5,0.5
"1657",1598,1,1,2,0.5,0.5
"1658",1599,1,1,2,0.5,0.5
"1659",1600,1,1,2,0.5,0.5
"1660",1601,1,1,2,0.5,0.5
"1661",1602,1,1,2,0.5,0.5
"1662",1603,1,1,2,0.5,0.5
"1663",1604,1,1,2,0.5,0.5
"1664",1605,1,1,2,0.5,0.5
"1665",1606,1,1,2,0.5,0.5
"1666",1607,1,1,2,0.5,0.5
"1667",1608,1,1,2,0.5,0.5
"1668",1609,1,1,2,0.5,0.5
"1669",1610,1,1,2,0.5,0.5
"1670",1611,1,1,2,0.5,0.5
"1671",1612,1,1,2,0.5,0.5
"1672",1613,1,1,2,0.5,0.5
"1673",1614,1,1,2,0.5,0.5
"1674",1615,1,1,2,0.5,0.5
"1675",1616,1,1,2,0.5,0.5
"1676",1617,1,1,2,0.5,0.5
"1677",1618,1,1,2,0.5,0.5
"1678",1619,1,1,2,0.5,0.5
"1679",1620,1,1,2,0.5,0.5
"1680",1621,1,1,2,0.5,0.5
"1681",1622,1,1,2,0.5,0.5
"1682",1623,1,1,2,0.5,0.5
"1683",1624,1,1,2,0.5,0.5
"1684",1625,1,1,2,0.5,0.5
"1685",1626,1,1,2,0.5,0.5
"1686",1627,1,1,2,0.5,0.5
"1687",1628,1,1,2,0.5,0.5
"1688",1629,1,1,2,0.5,0.5
"1689",1630,1,1,2,0.5,0.5
"1690",1631,1,1,2,0.5,0.5
"1691",1632,1,1,2,0.5,0.5
"1692",1633,1,1,2,0.5,0.5
"1693",1634,1,1,2,0.5,0.5
"1694",1635,1,1,2,0.5,0.5
"1695",1636,1,1,2,0.5,0.5
"1696",1637,1,1,2,0.5,0.5
"1697",1638,1,1,2,0.5,0.5
"1698",1639,1,1,2,0.5,0.5
"1699",1640,1,1,2,0.5,0.5
"1700",1641,1,1,2,0.5,0.5
"1701",1642,1,1,2,0.5,0.5
"1702",1643,1,1,2,0.5,0.5
"1703",1644,1,1,2,0.5,0.5
"1704",1645,1,1,2,0.5,0.5
"1705",1646,1,1,2,0.5,0.5
"1706",1647,1,1,2,0.5,0.5
"1707",1648,1,1,2,0.5,0.5
"1708",1649,1,1,2,0.5,0.5
"1709",1650,1,1,2,0.5,0.5
"1710",1651,1,1,2,0.5,0.5
"1711",1652,1,1,2,0.5,0.5
"1712",1653,1,1,2,0.5,0.5
"1713",1654,1,1,2,0.5,0.5
"1714",1655,1,1,2,0.5,0.5
"1715",1656,1,1,2,0.5,0.5
"1716",1657,1,1,2,0.5,0.5
"1717",1658,1,1,2,0.5,0.5
"1718",1659,1,1,2,0.5,0.5
"1719",1660,1,1,2,0.5,0.5
"1720",1661,1,1,2,0.5,0.5
"1721",1662,1,1,2,0.5,0.5
"1722",1663,1,1,2,0.5,0.5
"1723",1664,1,1,2,0.5,0.5
"1724",1666,1,1,2,0.5,0.5
"1725",1667,1,1,2,0.5,0.5
"1726",1668,1,1,2,0.5,0.5
"1727",1669,1,1,2,0.5,0.5
"1728",1670,1,1,2,0.5,0.5
"1729",1671,1,1,2,0.5,0.5
"1730",1672,1,1,2,0.5,0.5
"1731",1673,1,1,2,0.5,0.5
"1732",1674,1,1,2,0.5,0.5
"1733",1675,1,1,2,0.5,0.5
"1734",1676,1,1,2,0.5,0.5
"1735",1677,1,1,2,0.5,0.5
"1736",1678,1,1,2,0.5,0.5
"1737",1679,1,1,2,0.5,0.5
"1738",1680,1,1,2,0.5,0.5
"1739",1681,1,1,2,0.5,0.5
"1740",1682,1,1,2,0.5,0.5
"1741",1683,1,1,2,0.5,0.5
"1742",1684,1,1,2,0.5,0.5
"1743",1685,1,1,2,0.5,0.5
"1744",1686,1,1,2,0.5,0.5
"1745",1687,1,1,2,0.5,0.5
"1746",1688,1,1,2,0.5,0.5
"1747",1689,1,1,2,0.5,0.5
"1748",1690,1,1,2,0.5,0.5
"1749",1691,1,1,2,0.5,0.5
"1750",1692,1,1,2,0.5,0.5
"1751",1693,1,1,2,0.5,0.5
"1752",1694,1,1,2,0.5,0.5
"1753",1695,1,1,2,0.5,0.5
"1754",1696,1,1,2,0.5,0.5
"1755",1697,1,1,2,0.5,0.5
"1756",1698,1,1,2,0.5,0.5
"1757",1699,1,1,2,0.5,0.5
"1758",1700,1,1,2,0.5,0.5
"1759",1701,1,1,2,0.5,0.5
"1760",1702,1,1,2,0.5,0.5
"1761",1703,1,1,2,0.5,0.5
"1762",1704,1,1,2,0.5,0.5
"1763",1705,1,1,2,0.5,0.5
"1764",1706,1,1,2,0.5,0.5
"1765",1707,1,1,2,0.5,0.5
"1766",1708,1,1,2,0.5,0.5
"1767",1709,1,1,2,0.5,0.5
"1768",1710,1,1,2,0.5,0.5
"1769",1711,1,1,2,0.5,0.5
"1770",1712,1,1,2,0.5,0.5
"1771",1713,1,1,2,0.5,0.5
"1772",1714,1,1,2,0.5,0.5
"1773",1715,1,1,2,0.5,0.5
"1774",1716,1,1,2,0.5,0.5
"1775",1717,1,1,2,0.5,0.5
"1776",1718,1,1,2,0.5,0.5
"1777",1719,1,1,2,0.5,0.5
"1778",1720,1,1,2,0.5,0.5
"1779",1721,1,1,2,0.5,0.5
"1780",1722,1,1,2,0.5,0.5
"1781",1723,1,1,2,0.5,0.5
"1782",1724,1,1,2,0.5,0.5
"1783",1725,1,1,2,0.5,0.5
"1784",1726,1,1,2,0.5,0.5
"1785",1727,1,1,2,0.5,0.5
"1786",1728,1,1,2,0.5,0.5
"1787",1729,1,1,2,0.5,0.5
"1788",1730,1,1,2,0.5,0.5
"1789",1731,1,1,2,0.5,0.5
"1790",1732,1,1,2,0.5,0.5
"1791",1733,1,1,2,0.5,0.5
"1792",1734,1,1,2,0.5,0.5
"1793",1735,1,1,2,0.5,0.5
"1794",1736,1,1,2,0.5,0.5
"1795",1737,1,1,2,0.5,0.5
"1796",1738,1,1,2,0.5,0.5
"1797",1739,1,1,2,0.5,0.5
"1798",1740,1,1,2,0.5,0.5
"1799",1741,1,1,2,0.5,0.5
"1800",1742,1,1,2,0.5,0.5
"1801",1743,1,1,2,0.5,0.5
"1802",1744,1,1,2,0.5,0.5
"1803",1745,1,1,2,0.5,0.5
"1804",1746,1,1,2,0.5,0.5
"1805",1747,1,1,2,0.5,0.5
"1806",1748,1,1,2,0.5,0.5
"1807",1749,1,1,2,0.5,0.5
"1808",1750,1,1,2,0.5,0.5
"1809",1751,1,1,2,0.5,0.5
"1810",1752,1,1,2,0.5,0.5
"1811",1753,1,1,2,0.5,0.5
"1812",1754,1,1,2,0.5,0.5
"1813",1755,1,1,2,0.5,0.5
"1814",1756,1,1,2,0.5,0.5
"1815",1757,1,1,2,0.5,0.5
"1816",1758,1,1,2,0.5,0.5
"1817",1759,1,1,2,0.5,0.5
"1818",1760,1,1,2,0.5,0.5
"1819",1761,1,1,2,0.5,0.5
"1820",1762,1,1,2,0.5,0.5
"1821",1763,1,1,2,0.5,0.5
"1822",1764,1,1,2,0.5,0.5
"1823",1765,1,1,2,0.5,0.5
"1824",1766,1,1,2,0.5,0.5
"1825",1767,1,1,2,0.5,0.5
"1826",1768,1,1,2,0.5,0.5
"1827",1769,1,1,2,0.5,0.5
"1828",1770,1,1,2,0.5,0.5
"1829",1771,1,1,2,0.5,0.5
"1830",1772,1,1,2,0.5,0.5
"1831",1773,1,1,2,0.5,0.5
"1832",1774,1,1,2,0.5,0.5
"1833",1775,1,1,2,0.5,0.5
"1834",1776,1,1,2,0.5,0.5
"1835",1777,1,1,2,0.5,0.5
"1836",1778,1,1,2,0.5,0.5
"1837",1779,1,1,2,0.5,0.5
"1838",1780,1,1,2,0.5,0.5
"1839",1781,1,1,2,0.5,0.5
"1840",1782,1,1,2,0.5,0.5
"1841",1783,1,1,2,0.5,0.5
"1842",1784,1,1,2,0.5,0.5
"1843",1785,1,1,2,0.5,0.5
"1844",1786,1,1,2,0.5,0.5
"1845",1787,1,1,2,0.5,0.5
"1846",1788,1,1,2,0.5,0.5
"1847",1789,1,1,2,0.5,0.5
"1848",1790,1,1,2,0.5,0.5
"1849",1791,1,1,2,0.5,0.5
"1850",1792,1,1,2,0.5,0.5
"1851",1793,1,1,2,0.5,0.5
"1852",1794,1,1,2,0.5,0.5
"1853",1795,1,1,2,0.5,0.5
"1854",1796,1,1,2,0.5,0.5
"1855",1797,1,1,2,0.5,0.5
"1856",1798,1,1,2,0.5,0.5
"1857",1799,1,1,2,0.5,0.5
"1858",1800,1,1,2,0.5,0.5
"1859",1801,1,1,2,0.5,0.5
"1860",1802,1,1,2,0.5,0.5
"1861",1803,1,1,2,0.5,0.5
"1862",1804,1,1,2,0.5,0.5
"1863",1805,1,1,2,0.5,0.5
"1864",1806,1,1,2,0.5,0.5
"1865",1807,1,1,2,0.5,0.5
"1866",1808,1,1,2,0.5,0.5
"1867",1809,1,1,2,0.5,0.5
"1868",1810,1,1,2,0.5,0.5
"1869",1811,1,1,2,0.5,0.5
"1870",1812,1,1,2,0.5,0.5
"1871",1813,1,1,2,0.5,0.5
"1872",1814,1,1,2,0.5,0.5
"1873",1815,1,1,2,0.5,0.5
"1874",1816,1,1,2,0.5,0.5
"1875",1817,1,1,2,0.5,0.5
"1876",1818,1,1,2,0.5,0.5
"1877",1819,1,1,2,0.5,0.5
"1878",1820,1,1,2,0.5,0.5
"1879",1821,1,1,2,0.5,0.5
"1880",1822,1,1,2,0.5,0.5
"1881",1823,1,1,2,0.5,0.5
"1882",1824,1,1,2,0.5,0.5
"1883",1825,1,1,2,0.5,0.5
"1884",1826,1,1,2,0.5,0.5
"1885",1827,1,1,2,0.5,0.5
"1886",1828,1,1,2,0.5,0.5
"1887",1829,1,1,2,0.5,0.5
"1888",1830,1,1,2,0.5,0.5
"1889",1831,1,1,2,0.5,0.5
"1890",1832,1,1,2,0.5,0.5
"1891",1833,1,1,2,0.5,0.5
"1892",1834,1,1,2,0.5,0.5
"1893",1835,1,1,2,0.5,0.5
"1894",1836,1,1,2,0.5,0.5
"1895",1837,1,1,2,0.5,0.5
"1896",1838,1,1,2,0.5,0.5
"1897",1839,1,1,2,0.5,0.5
"1898",1840,1,1,2,0.5,0.5
"1899",1841,1,1,2,0.5,0.5
"1900",1842,1,1,2,0.5,0.5
"1901",1843,1,1,2,0.5,0.5
"1902",1844,1,1,2,0.5,0.5
"1903",1845,1,1,2,0.5,0.5
"1904",1846,1,1,2,0.5,0.5
"1905",1847,1,1,2,0.5,0.5
"1906",1848,1,1,2,0.5,0.5
"1907",1849,1,1,2,0.5,0.5
"1908",1850,1,1,2,0.5,0.5
"1909",1851,1,1,2,0.5,0.5
"1910",1852,1,1,2,0.5,0.5
"1911",1853,1,1,2,0.5,0.5
"1912",1854,1,1,2,0.5,0.5
"1913",1855,1,1,2,0.5,0.5
"1914",1856,1,1,2,0.5,0.5
"1915",1857,1,1,2,0.5,0.5
"1916",1858,1,1,2,0.5,0.5
"1917",1859,1,1,2,0.5,0.5
"1918",1860,1,1,2,0.5,0.5
"1919",1861,1,1,2,0.5,0.5
"1920",1862,1,1,2,0.5,0.5
"1921",1863,1,1,2,0.5,0.5
"1922",1864,1,1,2,0.5,0.5
"1923",1865,1,1,2,0.5,0.5
"1924",1866,1,1,2,0.5,0.5
"1925",1867,1,1,2,0.5,0.5
"1926",1868,1,1,2,0.5,0.5
"1927",1869,1,1,2,0.5,0.5
"1928",1870,1,1,2,0.5,0.5
"1929",1871,1,1,2,0.5,0.5
"1930",1872,1,1,2,0.5,0.5
"1931",1873,1,1,2,0.5,0.5
"1932",1874,1,1,2,0.5,0.5
"1933",1875,1,1,2,0.5,0.5
"1934",1876,1,1,2,0.5,0.5
"1935",1877,1,1,2,0.5,0.5
"1936",1878,1,1,2,0.5,0.5
"1937",1879,1,1,2,0.5,0.5
"1938",1880,1,1,2,0.5,0.5
"1939",1881,1,1,2,0.5,0.5
"1940",1882,1,1,2,0.5,0.5
"1941",1883,1,1,2,0.5,0.5
"1942",1884,1,1,2,0.5,0.5
"1943",1885,1,1,2,0.5,0.5
"1944",1886,1,1,2,0.5,0.5
"1945",1887,1,1,2,0.5,0.5
"1946",1888,1,1,2,0.5,0.5
"1947",1889,1,1,2,0.5,0.5
"1948",1890,1,1,2,0.5,0.5
"1949",1891,1,1,2,0.5,0.5
"1950",1892,1,1,2,0.5,0.5
"1951",1893,1,1,2,0.5,0.5
"1952",1894,1,1,2,0.5,0.5
"1953",1895,1,1,2,0.5,0.5
"1954",1896,1,1,2,0.5,0.5
"1955",1897,1,1,2,0.5,0.5
"1956",1898,1,1,2,0.5,0.5
"1957",1899,1,1,2,0.5,0.5
"1958",1900,1,1,2,0.5,0.5
"1959",1901,1,1,2,0.5,0.5
"1960",1902,1,1,2,0.5,0.5
"1961",1903,1,1,2,0.5,0.5
"1962",1904,1,1,2,0.5,0.5
"1963",1905,1,1,2,0.5,0.5
"1964",1906,1,1,2,0.5,0.5
"1965",1907,1,1,2,0.5,0.5
"1966",1908,1,1,2,0.5,0.5
"1967",1909,1,1,2,0.5,0.5
"1968",1910,1,1,2,0.5,0.5
"1969",1911,1,1,2,0.5,0.5
"1970",1912,1,1,2,0.5,0.5
"1971",1913,1,1,2,0.5,0.5
"1972",1914,1,1,2,0.5,0.5
"1973",1915,1,1,2,0.5,0.5
"1974",1916,1,1,2,0.5,0.5
"1975",1917,1,1,2,0.5,0.5
"1976",1918,1,1,2,0.5,0.5
"1977",1919,1,1,2,0.5,0.5
"1978",1920,1,1,2,0.5,0.5
"1979",1921,1,1,2,0.5,0.5
"1980",1922,1,1,2,0.5,0.5
"1981",1923,1,1,2,0.5,0.5
"1982",1924,1,1,2,0.5,0.5
"1983",1925,1,1,2,0.5,0.5
"1984",1926,1,1,2,0.5,0.5
"1985",1927,1,1,2,0.5,0.5
"1986",1928,1,1,2,0.5,0.5
"1987",1929,1,1,2,0.5,0.5
"1988",1930,1,1,2,0.5,0.5
"1989",1931,1,1,2,0.5,0.5
"1990",1932,1,1,2,0.5,0.5
"1991",1933,1,1,2,0.5,0.5
"1992",1934,1,1,2,0.5,0.5
"1993",1935,1,1,2,0.5,0.5
"1994",1936,1,1,2,0.5,0.5
"1995",1937,1,1,2,0.5,0.5
"1996",1938,1,1,2,0.5,0.5
"1997",1939,1,1,2,0.5,0.5
"1998",1940,1,1,2,0.5,0.5
"1999",1941,1,1,2,0.5,0.5
"2000",1942,1,1,2,0.5,0.5
"2001",1943,1,1,2,0.5,0.5
"2002",1944,1,1,2,0.5,0.5
"2003",1945,1,1,2,0.5,0.5
"2004",1946,1,1,2,0.5,0.5
"2005",1947,1,1,2,0.5,0.5
"2006",1948,1,1,2,0.5,0.5
"2007",1949,1,1,2,0.5,0.5
"2008",1950,1,1,2,0.5,0.5
"2009",1951,1,1,2,0.5,0.5
"2010",1952,1,1,2,0.5,0.5
"2011",1953,1,1,2,0.5,0.5
"2012",1954,1,1,2,0.5,0.5
"2013",1955,1,1,2,0.5,0.5
"2014",1956,1,1,2,0.5,0.5
"2015",1957,1,1,2,0.5,0.5
"2016",1958,1,1,2,0.5,0.5
"2017",1959,1,1,2,0.5,0.5
"2018",1960,1,1,2,0.5,0.5
"2019",1961,1,1,2,0.5,0.5
"2020",1962,1,1,2,0.5,0.5
"2021",1963,1,1,2,0.5,0.5
"2022",1964,1,1,2,0.5,0.5
"2023",1965,1,1,2,0.5,0.5
"2024",1966,1,1,2,0.5,0.5
"2025",1967,1,1,2,0.5,0.5
"2026",1968,1,1,2,0.5,0.5
"2027",1969,1,1,2,0.5,0.5
"2028",1970,1,1,2,0.5,0.5
"2029",1971,1,1,2,0.5,0.5
"2030",1972,1,1,2,0.5,0.5
"2031",1973,1,1,2,0.5,0.5
"2032",1974,1,1,2,0.5,0.5
"2033",1975,1,1,2,0.5,0.5
"2034",1976,1,1,2,0.5,0.5
"2035",1977,1,1,2,0.5,0.5
"2036",1978,1,1,2,0.5,0.5
"2037",1979,1,1,2,0.5,0.5
"2038",1980,1,1,2,0.5,0.5
"2039",1981,1,1,2,0.5,0.5
"2040",1982,1,1,2,0.5,0.5
"2041",1983,1,1,2,0.5,0.5
"2042",1984,1,1,2,0.5,0.5
"2043",1985,1,1,2,0.5,0.5
"2044",1986,1,1,2,0.5,0.5
"2045",1987,1,1,2,0.5,0.5
"2046",1988,1,1,2,0.5,0.5
"2047",1989,1,1,2,0.5,0.5
"2048",1990,1,1,2,0.5,0.5
"2049",1991,1,1,2,0.5,0.5
"2050",1992,1,1,2,0.5,0.5
"2051",1993,1,1,2,0.5,0.5
"2052",1994,1,1,2,0.5,0.5
"2053",1995,1,1,2,0.5,0.5
"2054",1996,1,1,2,0.5,0.5
"2055",1997,1,1,2,0.5,0.5
"2056",1998,1,1,2,0.5,0.5
"2057",1999,1,1,2,0.5,0.5
"2058",2000,1,1,2,0.5,0.5
"2059",2001,1,1,2,0.5,0.5
"2060",2002,1,1,2,0.5,0.5
"2061",2003,1,1,2,0.5,0.5
"2062",2004,1,1,2,0.5,0.5
"2063",2005,1,1,2,0.5,0.5
"2064",2006,1,1,2,0.5,0.5
"2065",2007,1,1,2,0.5,0.5
"2066",2008,1,1,2,0.5,0.5
"2067",2009,1,1,2,0.5,0.5
"2068",2010,1,1,2,0.5,0.5
"2069",2011,1,1,2,0.5,0.5
"2070",2012,1,1,2,0.5,0.5
"2071",2013,1,1,2,0.5,0.5
"2072",2014,1,1,2,0.5,0.5
"2073",2015,1,1,2,0.5,0.5
"2074",2016,1,1,2,0.5,0.5
"2075",2017,1,1,2,0.5,0.5
"2076",2018,1,1,2,0.5,0.5
"2077",2019,1,1,2,0.5,0.5
"2078",2020,1,1,2,0.5,0.5
"2079",2021,1,1,2,0.5,0.5
"2080",2022,1,1,2,0.5,0.5
"2081",2023,1,1,2,0.5,0.5
"2082",2024,1,1,2,0.5,0.5
"2083",2025,1,1,2,0.5,0.5
"2084",2026,1,1,2,0.5,0.5
"2085",2027,1,1,2,0.5,0.5
"2086",2028,1,1,2,0.5,0.5
"2087",2029,1,1,2,0.5,0.5
"2088",2030,1,1,2,0.5,0.5
"2089",2031,1,1,2,0.5,0.5
"2090",2032,1,1,2,0.5,0.5
"2091",2033,1,1,2,0.5,0.5
"2092",2034,1,1,2,0.5,0.5
"2093",2035,1,1,2,0.5,0.5
"2094",2036,1,1,2,0.5,0.5
"2095",2037,1,1,2,0.5,0.5
"2096",2038,1,1,2,0.5,0.5
"2097",2039,1,1,2,0.5,0.5
"2098",2040,1,1,2,0.5,0.5
"2099",2041,1,1,2,0.5,0.5
"2100",2042,1,1,2,0.5,0.5
"2101",2043,1,1,2,0.5,0.5
"2102",2044,1,1,2,0.5,0.5
"2103",2045,1,1,2,0.5,0.5
"2104",2046,1,1,2,0.5,0.5
"2105",2047,1,1,2,0.5,0.5
"2106",2048,1,1,2,0.5,0.5
"2107",2049,1,1,2,0.5,0.5
"2108",2050,1,1,2,0.5,0.5
"2109",2051,1,1,2,0.5,0.5
"2110",2052,1,1,2,0.5,0.5
"2111",2053,1,1,2,0.5,0.5
"2112",2054,1,1,2,0.5,0.5
"2113",2055,1,1,2,0.5,0.5
"2114",2056,1,1,2,0.5,0.5
"2115",2057,1,1,2,0.5,0.5
"2116",2058,1,1,2,0.5,0.5
"2117",2059,1,1,2,0.5,0.5
"2118",2060,1,1,2,0.5,0.5
"2119",2061,1,1,2,0.5,0.5
"2120",2062,1,1,2,0.5,0.5
"2121",2063,1,1,2,0.5,0.5
"2122",2064,1,1,2,0.5,0.5
"2123",2065,1,1,2,0.5,0.5
"2124",2066,1,1,2,0.5,0.5
"2125",2067,1,1,2,0.5,0.5
"2126",2068,1,1,2,0.5,0.5
"2127",2069,1,1,2,0.5,0.5
"2128",2070,1,1,2,0.5,0.5
"2129",2071,1,1,2,0.5,0.5
"2130",2072,1,1,2,0.5,0.5
"2131",2073,1,1,2,0.5,0.5
"2132",2074,1,1,2,0.5,0.5
"2133",2075,1,1,2,0.5,0.5
"2134",2076,1,1,2,0.5,0.5
"2135",2077,1,1,2,0.5,0.5
"2136",2078,1,1,2,0.5,0.5
"2137",2079,1,1,2,0.5,0.5
"2138",2080,1,1,2,0.5,0.5
"2139",2081,1,1,2,0.5,0.5
"2140",2082,1,1,2,0.5,0.5
"2141",2083,1,1,2,0.5,0.5
"2142",2084,1,1,2,0.5,0.5
"2143",2085,1,1,2,0.5,0.5
"2144",2086,1,1,2,0.5,0.5
"2145",2087,1,1,2,0.5,0.5
"2146",2088,1,1,2,0.5,0.5
"2147",2089,1,1,2,0.5,0.5
"2148",2090,1,1,2,0.5,0.5
"2149",2091,1,1,2,0.5,0.5
"2150",2092,1,1,2,0.5,0.5
"2151",2093,1,1,2,0.5,0.5
"2152",2094,1,1,2,0.5,0.5
"2153",2095,1,1,2,0.5,0.5
"2154",2096,1,1,2,0.5,0.5
"2155",2097,1,1,2,0.5,0.5
"2156",2098,1,1,2,0.5,0.5
"2157",2099,1,1,2,0.5,0.5
"2158",2100,1,1,2,0.5,0.5
"2159",2101,1,1,2,0.5,0.5
"2160",2102,1,1,2,0.5,0.5
"2161",2103,1,1,2,0.5,0.5
"2162",2104,1,1,2,0.5,0.5
"2163",2105,1,1,2,0.5,0.5
"2164",2106,1,1,2,0.5,0.5
"2165",2107,1,1,2,0.5,0.5
"2166",2108,1,1,2,0.5,0.5
"2167",2109,1,1,2,0.5,0.5
"2168",2110,1,1,2,0.5,0.5
"2169",2111,1,1,2,0.5,0.5
"2170",2112,1,1,2,0.5,0.5
"2171",2113,1,1,2,0.5,0.5
"2172",2114,1,1,2,0.5,0.5
"2173",2115,1,1,2,0.5,0.5
"2174",2116,1,1,2,0.5,0.5
"2175",2117,1,1,2,0.5,0.5
"2176",2118,1,1,2,0.5,0.5
"2177",2119,1,1,2,0.5,0.5
"2178",2120,1,1,2,0.5,0.5
"2179",2121,1,1,2,0.5,0.5
"2180",2122,1,1,2,0.5,0.5
"2181",2123,1,1,2,0.5,0.5
"2182",2124,1,1,2,0.5,0.5
"2183",2125,1,1,2,0.5,0.5
"2184",2126,1,1,2,0.5,0.5
"2185",2127,1,1,2,0.5,0.5
"2186",2128,1,1,2,0.5,0.5
"2187",2129,1,1,2,0.5,0.5
"2188",2130,1,1,2,0.5,0.5
"2189",2131,1,1,2,0.5,0.5
"2190",2132,1,1,2,0.5,0.5
"2191",2133,1,1,2,0.5,0.5
"2192",2134,1,1,2,0.5,0.5
"2193",2135,1,1,2,0.5,0.5
"2194",2136,1,1,2,0.5,0.5
"2195",2137,1,1,2,0.5,0.5
"2196",2138,1,1,2,0.5,0.5
"2197",2139,1,1,2,0.5,0.5
"2198",2140,1,1,2,0.5,0.5
"2199",2141,1,1,2,0.5,0.5
"2200",2142,1,1,2,0.5,0.5
"2201",2143,1,1,2,0.5,0.5
"2202",2144,1,1,2,0.5,0.5
"2203",2145,1,1,2,0.5,0.5
"2204",2146,1,1,2,0.5,0.5
"2205",2147,1,1,2,0.5,0.5
"2206",2148,1,1,2,0.5,0.5
"2207",2149,1,1,2,0.5,0.5
"2208",2150,1,1,2,0.5,0.5
"2209",2151,1,1,2,0.5,0.5
"2210",2152,1,1,2,0.5,0.5
"2211",2153,1,1,2,0.5,0.5
"2212",2154,1,1,2,0.5,0.5
"2213",2155,1,1,2,0.5,0.5
"2214",2156,1,1,2,0.5,0.5
"2215",2157,1,1,2,0.5,0.5
"2216",2158,1,1,2,0.5,0.5
"2217",2159,1,1,2,0.5,0.5
"2218",2160,1,1,2,0.5,0.5
"2219",2161,1,1,2,0.5,0.5
"2220",2162,1,1,2,0.5,0.5
"2221",2163,1,1,2,0.5,0.5
"2222",2164,1,1,2,0.5,0.5
"2223",2165,1,1,2,0.5,0.5
"2224",2166,1,1,2,0.5,0.5
"2225",2167,1,1,2,0.5,0.5
"2226",2168,1,1,2,0.5,0.5
"2227",2169,1,1,2,0.5,0.5
"2228",2170,1,1,2,0.5,0.5
"2229",2171,1,1,2,0.5,0.5
"2230",2172,1,1,2,0.5,0.5
"2231",2173,1,1,2,0.5,0.5
"2232",2174,1,1,2,0.5,0.5
"2233",2175,1,1,2,0.5,0.5
"2234",2176,1,1,2,0.5,0.5
"2235",2177,1,1,2,0.5,0.5
"2236",2178,1,1,2,0.5,0.5
"2237",2179,1,1,2,0.5,0.5
"2238",2180,1,1,2,0.5,0.5
"2239",2181,1,1,2,0.5,0.5
"2240",2182,1,1,2,0.5,0.5
"2241",2183,1,1,2,0.5,0.5
"2242",2184,1,1,2,0.5,0.5
"2243",2185,1,1,2,0.5,0.5
"2244",2186,1,1,2,0.5,0.5
"2245",2187,1,1,2,0.5,0.5
"2246",2188,1,1,2,0.5,0.5
"2247",2189,1,1,2,0.5,0.5
"2248",2190,1,1,2,0.5,0.5
"2249",2191,1,1,2,0.5,0.5
"2250",2192,1,1,2,0.5,0.5
"2251",2193,1,1,2,0.5,0.5
"2252",2194,1,1,2,0.5,0.5
"2253",2195,1,1,2,0.5,0.5
"2254",2196,1,1,2,0.5,0.5
"2255",2197,1,1,2,0.5,0.5
"2256",2198,1,1,2,0.5,0.5
"2257",2199,1,1,2,0.5,0.5
"2258",2200,1,1,2,0.5,0.5
"2259",2201,1,1,2,0.5,0.5
"2260",2202,1,1,2,0.5,0.5
"2261",2203,1,1,2,0.5,0.5
"2262",2204,1,1,2,0.5,0.5
"2263",2205,1,1,2,0.5,0.5
"2264",2206,1,1,2,0.5,0.5
"2265",2207,1,1,2,0.5,0.5
"2266",2208,1,1,2,0.5,0.5
"2267",2209,1,1,2,0.5,0.5
"2268",2210,1,1,2,0.5,0.5
"2269",2211,1,1,2,0.5,0.5
"2270",2212,1,1,2,0.5,0.5
"2271",2213,1,1,2,0.5,0.5
"2272",2214,1,1,2,0.5,0.5
"2273",2215,1,1,2,0.5,0.5
"2274",2216,1,1,2,0.5,0.5
"2275",2217,1,1,2,0.5,0.5
"2276",2218,1,1,2,0.5,0.5
"2277",2219,1,1,2,0.5,0.5
"2278",2220,1,1,2,0.5,0.5
"2279",2221,1,1,2,0.5,0.5
"2280",2222,1,1,2,0.5,0.5
"2281",2223,1,1,2,0.5,0.5
"2282",2224,1,1,2,0.5,0.5
"2283",2225,1,1,2,0.5,0.5
"2284",2226,1,1,2,0.5,0.5
"2285",2227,1,1,2,0.5,0.5
"2286",2228,1,1,2,0.5,0.5
"2287",2229,1,1,2,0.5,0.5
"2288",2230,1,1,2,0.5,0.5
"2289",2231,1,1,2,0.5,0.5
"2290",2232,1,1,2,0.5,0.5
"2291",2233,1,1,2,0.5,0.5
"2292",2234,1,1,2,0.5,0.5
"2293",2235,1,1,2,0.5,0.5
"2294",2236,1,1,2,0.5,0.5
"2295",2237,1,1,2,0.5,0.5
"2296",2238,1,1,2,0.5,0.5
"2297",2239,1,1,2,0.5,0.5
"2298",2240,1,1,2,0.5,0.5
"2299",2241,1,1,2,0.5,0.5
"2300",2242,1,1,2,0.5,0.5
"2301",2243,1,1,2,0.5,0.5
"2302",2244,1,1,2,0.5,0.5
"2303",2245,1,1,2,0.5,0.5
"2304",2246,1,1,2,0.5,0.5
"2305",2247,1,1,2,0.5,0.5
"2306",2248,1,1,2,0.5,0.5
"2307",2249,1,1,2,0.5,0.5
"2308",2250,1,1,2,0.5,0.5
"2309",2251,1,1,2,0.5,0.5
"2310",2252,1,1,2,0.5,0.5
"2311",2253,1,1,2,0.5,0.5
"2312",2254,1,1,2,0.5,0.5
"2313",2255,1,1,2,0.5,0.5
"2314",2256,1,1,2,0.5,0.5
"2315",2257,1,1,2,0.5,0.5
"2316",2258,1,1,2,0.5,0.5
"2317",2259,1,1,2,0.5,0.5
"2318",2260,1,1,2,0.5,0.5
"2319",2261,1,1,2,0.5,0.5
"2320",2262,1,1,2,0.5,0.5
"2321",2263,1,1,2,0.5,0.5
"2322",2264,1,1,2,0.5,0.5
"2323",2265,1,1,2,0.5,0.5
"2324",2266,1,1,2,0.5,0.5
"2325",2267,1,1,2,0.5,0.5
"2326",2268,1,1,2,0.5,0.5
"2327",2269,1,1,2,0.5,0.5
"2328",2270,1,1,2,0.5,0.5
"2329",2271,1,1,2,0.5,0.5
"2330",2272,1,1,2,0.5,0.5
"2331",2273,1,1,2,0.5,0.5
"2332",2274,1,1,2,0.5,0.5
"2333",2275,1,1,2,0.5,0.5
"2334",2276,1,1,2,0.5,0.5
"2335",2277,1,1,2,0.5,0.5
"2336",2278,1,1,2,0.5,0.5
"2337",2279,1,1,2,0.5,0.5
"2338",2280,1,1,2,0.5,0.5
"2339",2281,1,1,2,0.5,0.5
"2340",2282,1,1,2,0.5,0.5
"2341",2283,1,1,2,0.5,0.5
"2342",2284,1,1,2,0.5,0.5
"2343",2285,1,1,2,0.5,0.5
"2344",2286,1,1,2,0.5,0.5
"2345",2287,1,1,2,0.5,0.5
"2346",2288,1,1,2,0.5,0.5
"2347",2289,1,1,2,0.5,0.5
"2348",2290,1,1,2,0.5,0.5
"2349",2291,1,1,2,0.5,0.5
"2350",2292,1,1,2,0.5,0.5
"2351",2293,1,1,2,0.5,0.5
"2352",2294,1,1,2,0.5,0.5
"2353",2295,1,1,2,0.5,0.5
"2354",2296,1,1,2,0.5,0.5
"2355",2297,1,1,2,0.5,0.5
"2356",2298,1,1,2,0.5,0.5
"2357",2299,1,1,2,0.5,0.5
"2358",2300,1,1,2,0.5,0.5
"2359",2301,1,1,2,0.5,0.5
"2360",2302,1,1,2,0.5,0.5
"2361",2303,1,1,2,0.5,0.5
"2362",2304,1,1,2,0.5,0.5
"2363",2305,1,1,2,0.5,0.5
"2364",2306,1,1,2,0.5,0.5
"2365",2307,1,1,2,0.5,0.5
"2366",2308,1,1,2,0.5,0.5
"2367",2309,1,1,2,0.5,0.5
"2368",2310,1,1,2,0.5,0.5
"2369",2311,1,1,2,0.5,0.5
"2370",2312,1,1,2,0.5,0.5
"2371",2313,1,1,2,0.5,0.5
"2372",2314,1,1,2,0.5,0.5
"2373",2315,1,1,2,0.5,0.5
"2374",2316,1,1,2,0.5,0.5
"2375",2317,1,1,2,0.5,0.5
"2376",2318,1,1,2,0.5,0.5
"2377",2319,1,1,2,0.5,0.5
"2378",2320,1,1,2,0.5,0.5
"2379",2321,1,1,2,0.5,0.5
"2380",2322,1,1,2,0.5,0.5
"2381",2323,1,1,2,0.5,0.5
"2382",2324,1,1,2,0.5,0.5
"2383",2325,1,1,2,0.5,0.5
"2384",2326,1,1,2,0.5,0.5
"2385",2327,1,1,2,0.5,0.5
"2386",2328,1,1,2,0.5,0.5
"2387",2329,1,1,2,0.5,0.5
"2388",2330,1,1,2,0.5,0.5
"2389",2331,1,1,2,0.5,0.5
"2390",2332,1,1,2,0.5,0.5
"2391",2333,1,1,2,0.5,0.5
"2392",2334,1,1,2,0.5,0.5
"2393",2335,1,1,2,0.5,0.5
"2394",2336,1,1,2,0.5,0.5
"2395",2337,1,1,2,0.5,0.5
"2396",2338,1,1,2,0.5,0.5
"2397",2339,1,1,2,0.5,0.5
"2398",2340,1,1,2,0.5,0.5
"2399",2341,1,1,2,0.5,0.5
"2400",2342,1,1,2,0.5,0.5
"2401",2343,1,1,2,0.5,0.5
"2402",2344,1,1,2,0.5,0.5
"2403",2345,1,1,2,0.5,0.5
"2404",2346,1,1,2,0.5,0.5
"2405",2347,1,1,2,0.5,0.5
"2406",2348,1,1,2,0.5,0.5
"2407",2349,1,1,2,0.5,0.5
"2408",2350,1,1,2,0.5,0.5
"2409",2351,1,1,2,0.5,0.5
"2410",2352,1,1,2,0.5,0.5
"2411",2353,1,1,2,0.5,0.5
"2412",2354,1,1,2,0.5,0.5
"2413",2355,1,1,2,0.5,0.5
"2414",2356,1,1,2,0.5,0.5
"2415",2357,1,1,2,0.5,0.5
"2416",2358,1,1,2,0.5,0.5
"2417",2359,1,1,2,0.5,0.5
"2418",2360,1,1,2,0.5,0.5
"2419",2361,1,1,2,0.5,0.5
"2420",2362,1,1,2,0.5,0.5
"2421",2363,1,1,2,0.5,0.5
"2422",2364,1,1,2,0.5,0.5
"2423",2365,1,1,2,0.5,0.5
"2424",2366,1,1,2,0.5,0.5
"2425",2367,1,1,2,0.5,0.5
"2426",2368,1,1,2,0.5,0.5
"2427",2369,1,1,2,0.5,0.5
"2428",2370,1,1,2,0.5,0.5
"2429",2371,1,1,2,0.5,0.5
"2430",2372,1,1,2,0.5,0.5
"2431",2373,1,1,2,0.5,0.5
"2432",2374,1,1,2,0.5,0.5
"2433",2375,1,1,2,0.5,0.5
"2434",2376,1,1,2,0.5,0.5
"2435",2377,1,1,2,0.5,0.5
"2436",2378,1,1,2,0.5,0.5
"2437",2379,1,1,2,0.5,0.5
"2438",2380,1,1,2,0.5,0.5
"2439",2381,1,1,2,0.5,0.5
"2440",2382,1,1,2,0.5,0.5
"2441",2383,1,1,2,0.5,0.5
"2442",2384,1,1,2,0.5,0.5
"2443",2385,1,1,2,0.5,0.5
"2444",2386,1,1,2,0.5,0.5
"2445",2387,1,1,2,0.5,0.5
"2446",2388,1,1,2,0.5,0.5
"2447",2389,1,1,2,0.5,0.5
"2448",2390,1,1,2,0.5,0.5
"2449",2391,1,1,2,0.5,0.5
"2450",2392,1,1,2,0.5,0.5
"2451",2393,1,1,2,0.5,0.5
"2452",2394,1,1,2,0.5,0.5
"2453",2395,1,1,2,0.5,0.5
"2454",2396,1,1,2,0.5,0.5
"2455",2397,1,1,2,0.5,0.5
"2456",2398,1,1,2,0.5,0.5
"2457",2399,1,1,2,0.5,0.5
"2458",2400,1,1,2,0.5,0.5
"2459",2401,1,1,2,0.5,0.5
"2460",2402,1,1,2,0.5,0.5
"2461",2403,1,1,2,0.5,0.5
"2462",2404,1,1,2,0.5,0.5
"2463",2405,1,1,2,0.5,0.5
"2464",2406,1,1,2,0.5,0.5
"2465",2407,1,1,2,0.5,0.5
"2466",2408,1,1,2,0.5,0.5
"2467",2409,1,1,2,0.5,0.5
"2468",2410,1,1,2,0.5,0.5
"2469",2411,1,1,2,0.5,0.5
"2470",2412,1,1,2,0.5,0.5
"2471",2413,1,1,2,0.5,0.5
"2472",2414,1,1,2,0.5,0.5
"2473",2415,1,1,2,0.5,0.5
"2474",2416,1,1,2,0.5,0.5
"2475",2417,1,1,2,0.5,0.5
"2476",2418,1,1,2,0.5,0.5
"2477",2419,1,1,2,0.5,0.5
"2478",2420,1,1,2,0.5,0.5
"2479",2421,1,1,2,0.5,0.5
"2480",2422,1,1,2,0.5,0.5
"2481",2423,1,1,2,0.5,0.5
"2482",2424,1,1,2,0.5,0.5
"2483",2425,1,1,2,0.5,0.5
"2484",2426,1,1,2,0.5,0.5
"2485",2427,1,1,2,0.5,0.5
"2486",2428,1,1,2,0.5,0.5
"2487",2429,1,1,2,0.5,0.5
"2488",2430,1,1,2,0.5,0.5
"2489",2431,1,1,2,0.5,0.5
"2490",2432,1,1,2,0.5,0.5
"2491",2433,1,1,2,0.5,0.5
"2492",2434,1,1,2,0.5,0.5
"2493",2435,1,1,2,0.5,0.5
"2494",2436,1,1,2,0.5,0.5
"2495",2437,1,1,2,0.5,0.5
"2496",2438,1,1,2,0.5,0.5
"2497",2439,1,1,2,0.5,0.5
"2498",2440,1,1,2,0.5,0.5
"2499",2441,1,1,2,0.5,0.5
"2500",2442,1,1,2,0.5,0.5
"2501",2443,1,1,2,0.5,0.5
"2502",2444,1,1,2,0.5,0.5
"2503",2445,1,1,2,0.5,0.5
"2504",2446,1,1,2,0.5,0.5
"2505",2447,1,1,2,0.5,0.5
"2506",2448,1,1,2,0.5,0.5
"2507",2449,1,1,2,0.5,0.5
"2508",2450,1,1,2,0.5,0.5
"2509",2451,1,1,2,0.5,0.5
"2510",2452,1,1,2,0.5,0.5
"2511",2453,1,1,2,0.5,0.5
"2512",2454,1,1,2,0.5,0.5
"2513",2455,1,1,2,0.5,0.5
"2514",2456,1,1,2,0.5,0.5
"2515",2457,1,1,2,0.5,0.5
"2516",2458,1,1,2,0.5,0.5
"2517",2459,1,1,2,0.5,0.5
"2518",2460,1,1,2,0.5,0.5
"2519",2461,1,1,2,0.5,0.5
"2520",2462,1,1,2,0.5,0.5
"2521",2463,1,1,2,0.5,0.5
"2522",2464,1,1,2,0.5,0.5
"2523",2465,1,1,2,0.5,0.5
"2524",2466,1,1,2,0.5,0.5
"2525",2467,1,1,2,0.5,0.5
"2526",2468,1,1,2,0.5,0.5
"2527",2469,1,1,2,0.5,0.5
"2528",2470,1,1,2,0.5,0.5
"2529",2471,1,1,2,0.5,0.5
"2530",2472,1,1,2,0.5,0.5
"2531",2473,1,1,2,0.5,0.5
"2532",2474,1,1,2,0.5,0.5
"2533",2475,1,1,2,0.5,0.5
"2534",2476,1,1,2,0.5,0.5
"2535",2477,1,1,2,0.5,0.5
"2536",2478,1,1,2,0.5,0.5
"2537",2479,1,1,2,0.5,0.5
"2538",2480,1,1,2,0.5,0.5
"2539",2481,1,1,2,0.5,0.5
"2540",2482,1,1,2,0.5,0.5
"2541",2483,1,1,2,0.5,0.5
"2542",2484,1,1,2,0.5,0.5
"2543",2485,1,1,2,0.5,0.5
"2544",2486,1,1,2,0.5,0.5
"2545",2487,1,1,2,0.5,0.5
"2546",2488,1,1,2,0.5,0.5
"2547",2489,1,1,2,0.5,0.5
"2548",2490,1,1,2,0.5,0.5
"2549",2491,1,1,2,0.5,0.5
"2550",2492,1,1,2,0.5,0.5
"2551",2493,1,1,2,0.5,0.5
"2552",2494,1,1,2,0.5,0.5
"2553",2495,1,1,2,0.5,0.5
"2554",2496,1,1,2,0.5,0.5
"2555",2497,1,1,2,0.5,0.5
"2556",2498,1,1,2,0.5,0.5
"2557",2499,1,1,2,0.5,0.5
"2558",2500,1,1,2,0.5,0.5
"2559",2501,1,1,2,0.5,0.5
"2560",2502,1,1,2,0.5,0.5
"2561",2503,1,1,2,0.5,0.5
"2562",2504,1,1,2,0.5,0.5
"2563",2505,1,1,2,0.5,0.5
"2564",2506,1,1,2,0.5,0.5
"2565",2507,1,1,2,0.5,0.5
"2566",2508,1,1,2,0.5,0.5
"2567",2509,1,1,2,0.5,0.5
"2568",2510,1,1,2,0.5,0.5
"2569",2511,1,1,2,0.5,0.5
"2570",2512,1,1,2,0.5,0.5
"2571",2513,1,1,2,0.5,0.5
"2572",2514,1,1,2,0.5,0.5
"2573",2515,1,1,2,0.5,0.5
"2574",2516,1,1,2,0.5,0.5
"2575",2517,1,1,2,0.5,0.5
"2576",2518,1,1,2,0.5,0.5
"2577",2519,1,1,2,0.5,0.5
"2578",2520,1,1,2,0.5,0.5
"2579",2521,1,1,2,0.5,0.5
"2580",2522,1,1,2,0.5,0.5
"2581",2523,1,1,2,0.5,0.5
"2582",2524,1,1,2,0.5,0.5
"2583",2525,1,1,2,0.5,0.5
"2584",2526,1,1,2,0.5,0.5
"2585",2527,1,1,2,0.5,0.5
"2586",2528,1,1,2,0.5,0.5
"2587",2529,1,1,2,0.5,0.5
"2588",2530,1,1,2,0.5,0.5
"2589",2531,1,1,2,0.5,0.5
"2590",2532,1,1,2,0.5,0.5
"2591",2533,1,1,2,0.5,0.5
"2592",2534,1,1,2,0.5,0.5
"2593",2535,1,1,2,0.5,0.5
"2594",2536,1,1,2,0.5,0.5
"2595",2537,1,1,2,0.5,0.5
"2596",2538,1,1,2,0.5,0.5
"2597",2539,1,1,2,0.5,0.5
"2598",2540,1,1,2,0.5,0.5
"2599",2541,1,1,2,0.5,0.5
"2600",2542,1,1,2,0.5,0.5
"2601",2543,1,1,2,0.5,0.5
"2602",2544,1,1,2,0.5,0.5
"2603",2545,1,1,2,0.5,0.5
"2604",2546,1,1,2,0.5,0.5
"2605",2547,1,1,2,0.5,0.5
"2606",2548,1,1,2,0.5,0.5
"2607",2550,1,1,2,0.5,0.5
"2608",2551,1,1,2,0.5,0.5
"2609",2552,1,1,2,0.5,0.5
"2610",2553,1,1,2,0.5,0.5
"2611",2554,1,1,2,0.5,0.5
"2612",2555,1,1,2,0.5,0.5
"2613",2556,1,1,2,0.5,0.5
"2614",2557,1,1,2,0.5,0.5
"2615",2558,1,1,2,0.5,0.5
"2616",2559,1,1,2,0.5,0.5
"2617",2560,1,1,2,0.5,0.5
"2618",2561,1,1,2,0.5,0.5
"2619",2562,1,1,2,0.5,0.5
"2620",2563,1,1,2,0.5,0.5
"2621",2564,1,1,2,0.5,0.5
"2622",2565,1,1,2,0.5,0.5
"2623",2566,1,1,2,0.5,0.5
"2624",2567,1,1,2,0.5,0.5
"2625",2568,1,1,2,0.5,0.5
"2626",2569,1,1,2,0.5,0.5
"2627",2570,1,1,2,0.5,0.5
"2628",2571,1,1,2,0.5,0.5
"2629",2572,1,1,2,0.5,0.5
"2630",2573,1,1,2,0.5,0.5
"2631",2574,1,1,2,0.5,0.5
"2632",2575,1,1,2,0.5,0.5
"2633",2576,1,1,2,0.5,0.5
"2634",2577,1,1,2,0.5,0.5
"2635",2578,1,1,2,0.5,0.5
"2636",2579,1,1,2,0.5,0.5
"2637",2580,1,1,2,0.5,0.5
"2638",2581,1,1,2,0.5,0.5
"2639",2582,1,1,2,0.5,0.5
"2640",2583,1,1,2,0.5,0.5
"2641",2584,1,1,2,0.5,0.5
"2642",2585,1,1,2,0.5,0.5
"2643",2586,1,1,2,0.5,0.5
"2644",2587,1,1,2,0.5,0.5
"2645",2588,1,1,2,0.5,0.5
"2646",2589,1,1,2,0.5,0.5
"2647",2590,1,1,2,0.5,0.5
"2648",2591,1,1,2,0.5,0.5
"2649",2592,1,1,2,0.5,0.5
"2650",2594,1,1,2,0.5,0.5
"2651",2595,1,1,2,0.5,0.5
"2652",2596,1,1,2,0.5,0.5
"2653",2597,1,1,2,0.5,0.5
"2654",2598,1,1,2,0.5,0.5
"2655",2599,1,1,2,0.5,0.5
"2656",2600,1,1,2,0.5,0.5
"2657",2601,1,1,2,0.5,0.5
"2658",2602,1,1,2,0.5,0.5
"2659",2603,1,1,2,0.5,0.5
"2660",2604,1,1,2,0.5,0.5
"2661",2605,1,1,2,0.5,0.5
"2662",2606,1,1,2,0.5,0.5
"2663",2607,1,1,2,0.5,0.5
"2664",2608,1,1,2,0.5,0.5
"2665",2609,1,1,2,0.5,0.5
"2666",2610,1,1,2,0.5,0.5
"2667",2611,1,1,2,0.5,0.5
"2668",2612,1,1,2,0.5,0.5
"2669",2613,1,1,2,0.5,0.5
"2670",2614,1,1,2,0.5,0.5
"2671",2615,1,1,2,0.5,0.5
"2672",2616,1,1,2,0.5,0.5
"2673",2617,1,1,2,0.5,0.5
"2674",2618,1,1,2,0.5,0.5
"2675",2619,1,1,2,0.5,0.5
"2676",2620,1,1,2,0.5,0.5
"2677",2621,1,1,2,0.5,0.5
"2678",2622,1,1,2,0.5,0.5
"2679",2623,1,1,2,0.5,0.5
"2680",2624,1,1,2,0.5,0.5
"2681",2625,1,1,2,0.5,0.5
"2682",2626,1,1,2,0.5,0.5
"2683",2627,1,1,2,0.5,0.5
"2684",2628,1,1,2,0.5,0.5
"2685",2629,1,1,2,0.5,0.5
"2686",2630,1,1,2,0.5,0.5
"2687",2631,1,1,2,0.5,0.5
"2688",2632,1,1,2,0.5,0.5
"2689",2633,1,1,2,0.5,0.5
"2690",2634,1,1,2,0.5,0.5
"2691",2635,1,1,2,0.5,0.5
"2692",2636,1,1,2,0.5,0.5
"2693",2637,1,1,2,0.5,0.5
"2694",2638,1,1,2,0.5,0.5
"2695",2639,1,1,2,0.5,0.5
"2696",2640,1,1,2,0.5,0.5
"2697",2641,1,1,2,0.5,0.5
"2698",2642,1,1,2,0.5,0.5
"2699",2643,1,1,2,0.5,0.5
"2700",2644,1,1,2,0.5,0.5
"2701",2645,1,1,2,0.5,0.5
"2702",2646,1,1,2,0.5,0.5
"2703",2647,1,1,2,0.5,0.5
"2704",2648,1,1,2,0.5,0.5
"2705",2649,1,1,2,0.5,0.5
"2706",2650,1,1,2,0.5,0.5
"2707",2651,1,1,2,0.5,0.5
"2708",2652,1,1,2,0.5,0.5
"2709",2653,1,1,2,0.5,0.5
"2710",2654,1,1,2,0.5,0.5
"2711",2655,1,1,2,0.5,0.5
"2712",2656,1,1,2,0.5,0.5
"2713",2657,1,1,2,0.5,0.5
"2714",2658,1,1,2,0.5,0.5
"2715",2659,1,1,2,0.5,0.5
"2716",2660,1,1,2,0.5,0.5
"2717",2661,1,1,2,0.5,0.5
"2718",2662,1,1,2,0.5,0.5
"2719",2663,1,1,2,0.5,0.5
"2720",2664,1,1,2,0.5,0.5
"2721",2665,1,1,2,0.5,0.5
"2722",2666,1,1,2,0.5,0.5
"2723",2667,1,1,2,0.5,0.5
"2724",2668,1,1,2,0.5,0.5
"2725",2669,1,1,2,0.5,0.5
"2726",2670,1,1,2,0.5,0.5
"2727",2671,1,1,2,0.5,0.5
"2728",2672,1,1,2,0.5,0.5
"2729",2673,1,1,2,0.5,0.5
"2730",2674,1,1,2,0.5,0.5
"2731",2675,1,1,2,0.5,0.5
"2732",2676,1,1,2,0.5,0.5
"2733",2677,1,1,2,0.5,0.5
"2734",2678,1,1,2,0.5,0.5
"2735",2679,1,1,2,0.5,0.5
"2736",2680,1,1,2,0.5,0.5
"2737",2681,1,1,2,0.5,0.5
"2738",2682,1,1,2,0.5,0.5
"2739",2683,1,1,2,0.5,0.5
"2740",2684,1,1,2,0.5,0.5
"2741",2685,1,1,2,0.5,0.5
"2742",2686,1,1,2,0.5,0.5
"2743",2687,1,1,2,0.5,0.5
"2744",2688,1,1,2,0.5,0.5
"2745",2689,1,1,2,0.5,0.5
"2746",2690,1,1,2,0.5,0.5
"2747",2691,1,1,2,0.5,0.5
"2748",2692,1,1,2,0.5,0.5
"2749",2693,1,1,2,0.5,0.5
"2750",2694,1,1,2,0.5,0.5
"2751",2695,1,1,2,0.5,0.5
"2752",2696,1,1,2,0.5,0.5
"2753",2697,1,1,2,0.5,0.5
"2754",2698,1,1,2,0.5,0.5
"2755",2699,1,1,2,0.5,0.5
"2756",2700,1,1,2,0.5,0.5
"2757",2701,1,1,2,0.5,0.5
"2758",2702,1,1,2,0.5,0.5
"2759",2703,1,1,2,0.5,0.5
"2760",2704,1,1,2,0.5,0.5
"2761",2705,1,1,2,0.5,0.5
"2762",2706,1,1,2,0.5,0.5
"2763",2707,1,1,2,0.5,0.5
"2764",2708,1,1,2,0.5,0.5
"2765",2709,1,1,2,0.5,0.5
"2766",2710,1,1,2,0.5,0.5
"2767",2711,1,1,2,0.5,0.5
"2768",2712,1,1,2,0.5,0.5
"2769",2713,1,1,2,0.5,0.5
"2770",2714,1,1,2,0.5,0.5
"2771",2715,1,1,2,0.5,0.5
"2772",2716,1,1,2,0.5,0.5
"2773",2717,1,1,2,0.5,0.5
"2774",2718,1,1,2,0.5,0.5
"2775",2719,1,1,2,0.5,0.5
"2776",2720,1,1,2,0.5,0.5
"2777",2721,1,1,2,0.5,0.5
"2778",2722,1,1,2,0.5,0.5
"2779",2723,1,1,2,0.5,0.5
"2780",2724,1,1,2,0.5,0.5
"2781",2725,1,1,2,0.5,0.5
"2782",2726,1,1,2,0.5,0.5
"2783",2727,1,1,2,0.5,0.5
"2784",2728,1,1,2,0.5,0.5
"2785",2729,1,1,2,0.5,0.5
"2786",2730,1,1,2,0.5,0.5
"2787",2731,1,1,2,0.5,0.5
"2788",2732,1,1,2,0.5,0.5
"2789",2733,1,1,2,0.5,0.5
"2790",2734,1,1,2,0.5,0.5
"2791",2735,1,1,2,0.5,0.5
"2792",2736,1,1,2,0.5,0.5
"2793",2737,1,1,2,0.5,0.5
"2794",2738,1,1,2,0.5,0.5
"2795",2739,1,1,2,0.5,0.5
"2796",2740,1,1,2,0.5,0.5
"2797",2741,1,1,2,0.5,0.5
"2798",2742,1,1,2,0.5,0.5
"2799",2743,1,1,2,0.5,0.5
"2800",2744,1,1,2,0.5,0.5
"2801",2745,1,1,2,0.5,0.5
"2802",2746,1,1,2,0.5,0.5
"2803",2747,1,1,2,0.5,0.5
"2804",2748,1,1,2,0.5,0.5
"2805",2749,1,1,2,0.5,0.5
"2806",2750,1,1,2,0.5,0.5
"2807",2751,1,1,2,0.5,0.5
"2808",2752,1,1,2,0.5,0.5
"2809",2753,1,1,2,0.5,0.5
"2810",2754,1,1,2,0.5,0.5
"2811",2755,1,1,2,0.5,0.5
"2812",2756,1,1,2,0.5,0.5
"2813",2757,1,1,2,0.5,0.5
"2814",2758,1,1,2,0.5,0.5
"2815",2759,1,1,2,0.5,0.5
"2816",2760,1,1,2,0.5,0.5
"2817",2761,1,1,2,0.5,0.5
"2818",2762,1,1,2,0.5,0.5
"2819",2763,1,1,2,0.5,0.5
"2820",2764,1,1,2,0.5,0.5
"2821",2765,1,1,2,0.5,0.5
"2822",2766,1,1,2,0.5,0.5
"2823",2767,1,1,2,0.5,0.5
"2824",2768,1,1,2,0.5,0.5
"2825",2769,1,1,2,0.5,0.5
"2826",2770,1,1,2,0.5,0.5
"2827",2771,1,1,2,0.5,0.5
"2828",2772,1,1,2,0.5,0.5
"2829",2773,1,1,2,0.5,0.5
"2830",2774,1,1,2,0.5,0.5
"2831",2775,1,1,2,0.5,0.5
"2832",2776,1,1,2,0.5,0.5
"2833",2777,1,1,2,0.5,0.5
"2834",2778,1,1,2,0.5,0.5
"2835",2779,1,1,2,0.5,0.5
"2836",2781,1,1,2,0.5,0.5
"2837",2782,1,1,2,0.5,0.5
"2838",2783,1,1,2,0.5,0.5
"2839",2784,1,1,2,0.5,0.5
"2840",2785,1,1,2,0.5,0.5
"2841",2786,1,1,2,0.5,0.5
"2842",2787,1,1,2,0.5,0.5
"2843",2788,1,1,2,0.5,0.5
"2844",2789,1,1,2,0.5,0.5
"2845",2790,1,1,2,0.5,0.5
"2846",2791,1,1,2,0.5,0.5
"2847",2792,1,1,2,0.5,0.5
"2848",2793,1,1,2,0.5,0.5
"2849",2794,1,1,2,0.5,0.5
"2850",2795,1,1,2,0.5,0.5
"2851",2796,1,1,2,0.5,0.5
"2852",2797,1,1,2,0.5,0.5
"2853",2798,1,1,2,0.5,0.5
"2854",2799,1,1,2,0.5,0.5
"2855",2800,1,1,2,0.5,0.5
"2856",2801,1,1,2,0.5,0.5
"2857",2802,1,1,2,0.5,0.5
"2858",2803,1,1,2,0.5,0.5
"2859",2804,1,1,2,0.5,0.5
"2860",2805,1,1,2,0.5,0.5
"2861",2806,1,1,2,0.5,0.5
"2862",2807,1,1,2,0.5,0.5
"2863",2808,1,1,2,0.5,0.5
"2864",2809,1,1,2,0.5,0.5
"2865",2810,1,1,2,0.5,0.5
"2866",2811,1,1,2,0.5,0.5
"2867",2812,1,1,2,0.5,0.5
"2868",2813,1,1,2,0.5,0.5
"2869",2814,1,1,2,0.5,0.5
"2870",2815,1,1,2,0.5,0.5
"2871",2816,1,1,2,0.5,0.5
"2872",2817,1,1,2,0.5,0.5
"2873",2818,1,1,2,0.5,0.5
"2874",2819,1,1,2,0.5,0.5
"2875",2820,1,1,2,0.5,0.5
"2876",2821,1,1,2,0.5,0.5
"2877",2822,1,1,2,0.5,0.5
"2878",2823,1,1,2,0.5,0.5
"2879",2824,1,1,2,0.5,0.5
"2880",2825,1,1,2,0.5,0.5
"2881",2826,1,1,2,0.5,0.5
"2882",2827,1,1,2,0.5,0.5
"2883",2828,1,1,2,0.5,0.5
"2884",2829,1,1,2,0.5,0.5
"2885",2830,1,1,2,0.5,0.5
"2886",2831,1,1,2,0.5,0.5
"2887",2832,1,1,2,0.5,0.5
"2888",2833,1,1,2,0.5,0.5
"2889",2834,1,1,2,0.5,0.5
"2890",2835,1,1,2,0.5,0.5
"2891",2836,1,1,2,0.5,0.5
"2892",2837,1,1,2,0.5,0.5
"2893",2838,1,1,2,0.5,0.5
"2894",2839,1,1,2,0.5,0.5
"2895",2840,1,1,2,0.5,0.5
"2896",2841,1,1,2,0.5,0.5
"2897",2842,1,1,2,0.5,0.5
"2898",2843,1,1,2,0.5,0.5
"2899",2844,1,1,2,0.5,0.5
"2900",2845,1,1,2,0.5,0.5
"2901",2846,1,1,2,0.5,0.5
"2902",2847,1,1,2,0.5,0.5
"2903",2848,1,1,2,0.5,0.5
"2904",2849,1,1,2,0.5,0.5
"2905",2850,1,1,2,0.5,0.5
"2906",2851,1,1,2,0.5,0.5
"2907",2852,1,1,2,0.5,0.5
"2908",2853,1,1,2,0.5,0.5
"2909",2854,1,1,2,0.5,0.5
"2910",2855,1,1,2,0.5,0.5
"2911",2856,1,1,2,0.5,0.5
"2912",2857,1,1,2,0.5,0.5
"2913",2858,1,1,2,0.5,0.5
"2914",2859,1,1,2,0.5,0.5
"2915",2860,1,1,2,0.5,0.5
"2916",2861,1,1,2,0.5,0.5
"2917",2862,1,1,2,0.5,0.5
"2918",2863,1,1,2,0.5,0.5
"2919",2864,1,1,2,0.5,0.5
"2920",2865,1,1,2,0.5,0.5
"2921",2866,1,1,2,0.5,0.5
"2922",2867,1,1,2,0.5,0.5
"2923",2868,1,1,2,0.5,0.5
"2924",2869,1,1,2,0.5,0.5
"2925",2870,1,1,2,0.5,0.5
"2926",2871,1,1,2,0.5,0.5
"2927",2872,1,1,2,0.5,0.5
"2928",2873,1,1,2,0.5,0.5
"2929",2874,1,1,2,0.5,0.5
"2930",2875,1,1,2,0.5,0.5
"2931",2876,1,1,2,0.5,0.5
"2932",2877,1,1,2,0.5,0.5
"2933",2878,1,1,2,0.5,0.5
"2934",2879,1,1,2,0.5,0.5
"2935",2880,1,1,2,0.5,0.5
"2936",2881,1,1,2,0.5,0.5
"2937",2882,1,1,2,0.5,0.5
"2938",2883,1,1,2,0.5,0.5
"2939",2885,1,1,2,0.5,0.5
"2940",2886,1,1,2,0.5,0.5
"2941",2887,1,1,2,0.5,0.5
"2942",2888,1,1,2,0.5,0.5
"2943",2889,1,1,2,0.5,0.5
"2944",2890,1,1,2,0.5,0.5
"2945",2891,1,1,2,0.5,0.5
"2946",2892,1,1,2,0.5,0.5
"2947",2893,1,1,2,0.5,0.5
"2948",2894,1,1,2,0.5,0.5
"2949",2895,1,1,2,0.5,0.5
"2950",2896,1,1,2,0.5,0.5
"2951",2897,1,1,2,0.5,0.5
"2952",2898,1,1,2,0.5,0.5
"2953",2899,1,1,2,0.5,0.5
"2954",2900,1,1,2,0.5,0.5
"2955",2901,1,1,2,0.5,0.5
"2956",2902,1,1,2,0.5,0.5
"2957",2903,1,1,2,0.5,0.5
"2958",2904,1,1,2,0.5,0.5
"2959",2905,1,1,2,0.5,0.5
"2960",2906,1,1,2,0.5,0.5
"2961",2907,1,1,2,0.5,0.5
"2962",2908,1,1,2,0.5,0.5
"2963",2909,1,1,2,0.5,0.5
"2964",2910,1,1,2,0.5,0.5
"2965",2911,1,1,2,0.5,0.5
"2966",2912,1,1,2,0.5,0.5
"2967",2913,1,1,2,0.5,0.5
"2968",2914,1,1,2,0.5,0.5
"2969",2915,1,1,2,0.5,0.5
"2970",2916,1,1,2,0.5,0.5
"2971",2917,1,1,2,0.5,0.5
"2972",2918,1,1,2,0.5,0.5
"2973",2919,1,1,2,0.5,0.5
"2974",2920,1,1,2,0.5,0.5
"2975",2921,1,1,2,0.5,0.5
"2976",2922,1,1,2,0.5,0.5
"2977",2923,1,1,2,0.5,0.5
"2978",2924,1,1,2,0.5,0.5
"2979",2925,1,1,2,0.5,0.5
"2980",2926,1,1,2,0.5,0.5
"2981",2927,1,1,2,0.5,0.5
"2982",2928,1,1,2,0.5,0.5
"2983",2929,1,1,2,0.5,0.5
"2984",2930,1,1,2,0.5,0.5
"2985",2931,1,1,2,0.5,0.5
"2986",2932,1,1,2,0.5,0.5
"2987",2933,1,1,2,0.5,0.5
"2988",2934,1,1,2,0.5,0.5
"2989",2935,1,1,2,0.5,0.5
"2990",2936,1,1,2,0.5,0.5
"2991",2937,1,1,2,0.5,0.5
"2992",2938,1,1,2,0.5,0.5
"2993",2939,1,1,2,0.5,0.5
"2994",2940,1,1,2,0.5,0.5
"2995",2941,1,1,2,0.5,0.5
"2996",2942,1,1,2,0.5,0.5
"2997",2943,1,1,2,0.5,0.5
"2998",2944,1,1,2,0.5,0.5
"2999",2945,1,1,2,0.5,0.5
"3000",2946,1,1,2,0.5,0.5
"3001",2947,1,1,2,0.5,0.5
"3002",2948,1,1,2,0.5,0.5
"3003",2949,1,1,2,0.5,0.5
"3004",2950,1,1,2,0.5,0.5
"3005",2951,1,1,2,0.5,0.5
"3006",2952,1,1,2,0.5,0.5
"3007",2953,1,1,2,0.5,0.5
"3008",2954,1,1,2,0.5,0.5
"3009",2955,1,1,2,0.5,0.5
"3010",2956,1,1,2,0.5,0.5
"3011",2957,1,1,2,0.5,0.5
"3012",2958,1,1,2,0.5,0.5
"3013",2959,1,1,2,0.5,0.5
"3014",2960,1,1,2,0.5,0.5
"3015",2961,1,1,2,0.5,0.5
"3016",2962,1,1,2,0.5,0.5
"3017",2963,1,1,2,0.5,0.5
"3018",2964,1,1,2,0.5,0.5
"3019",2965,1,1,2,0.5,0.5
"3020",2966,1,1,2,0.5,0.5
"3021",2967,1,1,2,0.5,0.5
"3022",2968,1,1,2,0.5,0.5
"3023",2969,1,1,2,0.5,0.5
"3024",2970,1,1,2,0.5,0.5
"3025",2971,1,1,2,0.5,0.5
"3026",2972,1,1,2,0.5,0.5
"3027",2973,1,1,2,0.5,0.5
"3028",2974,1,1,2,0.5,0.5
"3029",2975,1,1,2,0.5,0.5
"3030",2976,1,1,2,0.5,0.5
"3031",2977,1,1,2,0.5,0.5
"3032",2978,1,1,2,0.5,0.5
"3033",2979,1,1,2,0.5,0.5
"3034",2980,1,1,2,0.5,0.5
"3035",2981,1,1,2,0.5,0.5
"3036",2982,1,1,2,0.5,0.5
"3037",2983,1,1,2,0.5,0.5
"3038",2984,1,1,2,0.5,0.5
"3039",2985,1,1,2,0.5,0.5
"3040",2986,1,1,2,0.5,0.5
"3041",2987,1,1,2,0.5,0.5
"3042",2988,1,1,2,0.5,0.5
"3043",2989,1,1,2,0.5,0.5
"3044",2990,1,1,2,0.5,0.5
"3045",2991,1,1,2,0.5,0.5
"3046",2992,1,1,2,0.5,0.5
"3047",2993,1,1,2,0.5,0.5
"3048",2994,1,1,2,0.5,0.5
"3049",2995,1,1,2,0.5,0.5
"3050",2996,1,1,2,0.5,0.5
"3051",2997,1,1,2,0.5,0.5
"3052",2998,1,1,2,0.5,0.5
"3053",2999,1,1,2,0.5,0.5
"3054",3000,1,1,2,0.5,0.5
"3055",3001,1,1,2,0.5,0.5
"3056",3002,1,1,2,0.5,0.5
"3057",3003,1,1,2,0.5,0.5
"3058",3004,1,1,2,0.5,0.5
"3059",3005,1,1,2,0.5,0.5
"3060",3006,1,1,2,0.5,0.5
"3061",3007,1,1,2,0.5,0.5
"3062",3008,1,1,2,0.5,0.5
"3063",3009,1,1,2,0.5,0.5
"3064",3010,1,1,2,0.5,0.5
"3065",3011,1,1,2,0.5,0.5
"3066",3012,1,1,2,0.5,0.5
"3067",3013,1,1,2,0.5,0.5
"3068",3014,1,1,2,0.5,0.5
"3069",3015,1,1,2,0.5,0.5
"3070",3016,1,1,2,0.5,0.5
"3071",3017,1,1,2,0.5,0.5
"3072",3018,1,1,2,0.5,0.5
"3073",3019,1,1,2,0.5,0.5
"3074",3020,1,1,2,0.5,0.5
"3075",3021,1,1,2,0.5,0.5
"3076",3022,1,1,2,0.5,0.5
"3077",3023,1,1,2,0.5,0.5
"3078",3024,1,1,2,0.5,0.5
"3079",3025,1,1,2,0.5,0.5
"3080",3026,1,1,2,0.5,0.5
"3081",3027,1,1,2,0.5,0.5
"3082",3028,1,1,2,0.5,0.5
"3083",3029,1,1,2,0.5,0.5
"3084",3030,1,1,2,0.5,0.5
"3085",3031,1,1,2,0.5,0.5
"3086",3032,1,1,2,0.5,0.5
"3087",3033,1,1,2,0.5,0.5
"3088",3034,1,1,2,0.5,0.5
"3089",3035,1,1,2,0.5,0.5
"3090",3036,1,1,2,0.5,0.5
"3091",3037,1,1,2,0.5,0.5
"3092",3038,1,1,2,0.5,0.5
"3093",3039,1,1,2,0.5,0.5
"3094",3040,1,1,2,0.5,0.5
"3095",3041,1,1,2,0.5,0.5
"3096",3042,1,1,2,0.5,0.5
"3097",3043,1,1,2,0.5,0.5
"3098",3044,1,1,2,0.5,0.5
"3099",3045,1,1,2,0.5,0.5
"3100",3046,1,1,2,0.5,0.5
"3101",3047,1,1,2,0.5,0.5
"3102",3048,1,1,2,0.5,0.5
"3103",3049,1,1,2,0.5,0.5
"3104",3050,1,1,2,0.5,0.5
"3105",3051,1,1,2,0.5,0.5
"3106",3052,1,1,2,0.5,0.5
"3107",3053,1,1,2,0.5,0.5
"3108",3054,1,1,2,0.5,0.5
"3109",3055,1,1,2,0.5,0.5
"3110",3056,1,1,2,0.5,0.5
"3111",3057,1,1,2,0.5,0.5
"3112",3058,1,1,2,0.5,0.5
"3113",3059,1,1,2,0.5,0.5
"3114",3060,1,1,2,0.5,0.5
"3115",3061,1,1,2,0.5,0.5
"3116",3062,1,1,2,0.5,0.5
"3117",3063,1,1,2,0.5,0.5
"3118",3064,1,1,2,0.5,0.5
"3119",3065,1,1,2,0.5,0.5
"3120",3066,1,1,2,0.5,0.5
"3121",3067,1,1,2,0.5,0.5
"3122",3068,1,1,2,0.5,0.5
"3123",3069,1,1,2,0.5,0.5
"3124",3070,1,1,2,0.5,0.5
"3125",3071,1,1,2,0.5,0.5
"3126",3072,1,1,2,0.5,0.5
"3127",3073,1,1,2,0.5,0.5
"3128",3074,1,1,2,0.5,0.5
"3129",3075,1,1,2,0.5,0.5
"3130",3076,1,1,2,0.5,0.5
"3131",3077,1,1,2,0.5,0.5
"3132",3078,1,1,2,0.5,0.5
"3133",3079,1,1,2,0.5,0.5
"3134",3080,1,1,2,0.5,0.5
"3135",3081,1,1,2,0.5,0.5
"3136",3082,1,1,2,0.5,0.5
"3137",3083,1,1,2,0.5,0.5
"3138",3084,1,1,2,0.5,0.5
"3139",3085,1,1,2,0.5,0.5
"3140",3086,1,1,2,0.5,0.5
"3141",3087,1,1,2,0.5,0.5
"3142",3088,1,1,2,0.5,0.5
"3143",3089,1,1,2,0.5,0.5
"3144",3090,1,1,2,0.5,0.5
"3145",3091,1,1,2,0.5,0.5
"3146",3092,1,1,2,0.5,0.5
"3147",3093,1,1,2,0.5,0.5
"3148",3094,1,1,2,0.5,0.5
"3149",3095,1,1,2,0.5,0.5
"3150",3096,1,1,2,0.5,0.5
"3151",3097,1,1,2,0.5,0.5
"3152",3098,1,1,2,0.5,0.5
"3153",3099,1,1,2,0.5,0.5
"3154",3100,1,1,2,0.5,0.5
"3155",3101,1,1,2,0.5,0.5
"3156",3102,1,1,2,0.5,0.5
"3157",3103,1,1,2,0.5,0.5
"3158",3104,1,1,2,0.5,0.5
"3159",3105,1,1,2,0.5,0.5
"3160",3106,1,1,2,0.5,0.5
"3161",3107,1,1,2,0.5,0.5
"3162",3108,1,1,2,0.5,0.5
"3163",3109,1,1,2,0.5,0.5
"3164",3111,1,1,2,0.5,0.5
"3165",3112,1,1,2,0.5,0.5
"3166",3113,1,1,2,0.5,0.5
"3167",3114,1,1,2,0.5,0.5
"3168",3115,1,1,2,0.5,0.5
"3169",3116,1,1,2,0.5,0.5
"3170",3117,1,1,2,0.5,0.5
"3171",3118,1,1,2,0.5,0.5
"3172",3119,1,1,2,0.5,0.5
"3173",3120,1,1,2,0.5,0.5
"3174",3121,1,1,2,0.5,0.5
"3175",3122,1,1,2,0.5,0.5
"3176",3123,1,1,2,0.5,0.5
"3177",3124,1,1,2,0.5,0.5
"3178",3125,1,1,2,0.5,0.5
"3179",3126,1,1,2,0.5,0.5
"3180",3127,1,1,2,0.5,0.5
"3181",3128,1,1,2,0.5,0.5
"3182",3129,1,1,2,0.5,0.5
"3183",3130,1,1,2,0.5,0.5
"3184",3131,1,1,2,0.5,0.5
"3185",3132,1,1,2,0.5,0.5
"3186",3133,1,1,2,0.5,0.5
"3187",3134,1,1,2,0.5,0.5
"3188",3135,1,1,2,0.5,0.5
"3189",3136,1,1,2,0.5,0.5
"3190",3137,1,1,2,0.5,0.5
"3191",3138,1,1,2,0.5,0.5
"3192",3139,1,1,2,0.5,0.5
"3193",3140,1,1,2,0.5,0.5
"3194",3141,1,1,2,0.5,0.5
"3195",3142,1,1,2,0.5,0.5
"3196",3143,1,1,2,0.5,0.5
"3197",3144,1,1,2,0.5,0.5
"3198",3145,1,1,2,0.5,0.5
"3199",3146,1,1,2,0.5,0.5
"3200",3147,1,1,2,0.5,0.5
"3201",3148,1,1,2,0.5,0.5
"3202",3149,1,1,2,0.5,0.5
"3203",3150,1,1,2,0.5,0.5
"3204",3151,1,1,2,0.5,0.5
"3205",3152,1,1,2,0.5,0.5
"3206",3153,1,1,2,0.5,0.5
"3207",3154,1,1,2,0.5,0.5
"3208",3155,1,1,2,0.5,0.5
"3209",3156,1,1,2,0.5,0.5
"3210",3157,1,1,2,0.5,0.5
"3211",3158,1,1,2,0.5,0.5
"3212",3159,1,1,2,0.5,0.5
"3213",3160,1,1,2,0.5,0.5
"3214",3161,1,1,2,0.5,0.5
"3215",3162,1,1,2,0.5,0.5
"3216",3163,1,1,2,0.5,0.5
"3217",3164,1,1,2,0.5,0.5
"3218",3165,1,1,2,0.5,0.5
"3219",3166,1,1,2,0.5,0.5
"3220",3167,1,1,2,0.5,0.5
"3221",3168,1,1,2,0.5,0.5
"3222",3169,1,1,2,0.5,0.5
"3223",3170,1,1,2,0.5,0.5
"3224",3171,1,1,2,0.5,0.5
"3225",3172,1,1,2,0.5,0.5
"3226",3173,1,1,2,0.5,0.5
"3227",3174,1,1,2,0.5,0.5
"3228",3175,1,1,2,0.5,0.5
"3229",3176,1,1,2,0.5,0.5
"3230",3177,1,1,2,0.5,0.5
"3231",3178,1,1,2,0.5,0.5
"3232",3179,1,1,2,0.5,0.5
"3233",3180,1,1,2,0.5,0.5
"3234",3181,1,1,2,0.5,0.5
"3235",3182,1,1,2,0.5,0.5
"3236",3183,1,1,2,0.5,0.5
"3237",3184,1,1,2,0.5,0.5
"3238",3185,1,1,2,0.5,0.5
"3239",3186,1,1,2,0.5,0.5
"3240",3187,1,1,2,0.5,0.5
"3241",3188,1,1,2,0.5,0.5
"3242",3189,1,1,2,0.5,0.5
"3243",3190,1,1,2,0.5,0.5
"3244",3191,1,1,2,0.5,0.5
"3245",3192,1,1,2,0.5,0.5
"3246",3193,1,1,2,0.5,0.5
"3247",3194,1,1,2,0.5,0.5
"3248",3195,1,1,2,0.5,0.5
"3249",3196,1,1,2,0.5,0.5
"3250",3197,1,1,2,0.5,0.5
"3251",3198,1,1,2,0.5,0.5
"3252",3199,1,1,2,0.5,0.5
"3253",3200,1,1,2,0.5,0.5
"3254",3201,1,1,2,0.5,0.5
"3255",3202,1,1,2,0.5,0.5
"3256",3203,1,1,2,0.5,0.5
"3257",3204,1,1,2,0.5,0.5
"3258",3205,1,1,2,0.5,0.5
"3259",3206,1,1,2,0.5,0.5
"3260",3207,1,1,2,0.5,0.5
"3261",3208,1,1,2,0.5,0.5
"3262",3209,1,1,2,0.5,0.5
"3263",3210,1,1,2,0.5,0.5
"3264",3211,1,1,2,0.5,0.5
"3265",3212,1,1,2,0.5,0.5
"3266",3213,1,1,2,0.5,0.5
"3267",3214,1,1,2,0.5,0.5
"3268",3215,1,1,2,0.5,0.5
"3269",3216,1,1,2,0.5,0.5
"3270",3217,1,1,2,0.5,0.5
"3271",3218,1,1,2,0.5,0.5
"3272",3219,1,1,2,0.5,0.5
"3273",3220,1,1,2,0.5,0.5
"3274",3221,1,1,2,0.5,0.5
"3275",3222,1,1,2,0.5,0.5
"3276",3223,1,1,2,0.5,0.5
"3277",3224,1,1,2,0.5,0.5
"3278",3225,1,1,2,0.5,0.5
"3279",3226,1,1,2,0.5,0.5
"3280",3227,1,1,2,0.5,0.5
"3281",3228,1,1,2,0.5,0.5
"3282",3229,1,1,2,0.5,0.5
"3283",3230,1,1,2,0.5,0.5
"3284",3231,1,1,2,0.5,0.5
"3285",3232,1,1,2,0.5,0.5
"3286",3233,1,1,2,0.5,0.5
"3287",3234,1,1,2,0.5,0.5
"3288",3235,1,1,2,0.5,0.5
"3289",3236,1,1,2,0.5,0.5
"3290",3237,1,1,2,0.5,0.5
"3291",3238,1,1,2,0.5,0.5
"3292",3239,1,1,2,0.5,0.5
"3293",3240,1,1,2,0.5,0.5
"3294",3241,1,1,2,0.5,0.5
"3295",3242,1,1,2,0.5,0.5
"3296",3243,1,1,2,0.5,0.5
"3297",3244,1,1,2,0.5,0.5
"3298",3245,1,1,2,0.5,0.5
"3299",3246,1,1,2,0.5,0.5
"3300",3247,1,1,2,0.5,0.5
"3301",3248,1,1,2,0.5,0.5
"3302",3250,1,1,2,0.5,0.5
"3303",3251,1,1,2,0.5,0.5
"3304",3252,1,1,2,0.5,0.5
"3305",3253,1,1,2,0.5,0.5
"3306",3254,1,1,2,0.5,0.5
"3307",3255,1,1,2,0.5,0.5
"3308",3256,1,1,2,0.5,0.5
"3309",3257,1,1,2,0.5,0.5
"3310",3258,1,1,2,0.5,0.5
"3311",3259,1,1,2,0.5,0.5
"3312",3260,1,1,2,0.5,0.5
"3313",3261,1,1,2,0.5,0.5
"3314",3262,1,1,2,0.5,0.5
"3315",3263,1,1,2,0.5,0.5
"3316",3264,1,1,2,0.5,0.5
"3317",3265,1,1,2,0.5,0.5
"3318",3266,1,1,2,0.5,0.5
"3319",3267,1,1,2,0.5,0.5
"3320",3268,1,1,2,0.5,0.5
"3321",3269,1,1,2,0.5,0.5
"3322",3270,1,1,2,0.5,0.5
"3323",3271,1,1,2,0.5,0.5
"3324",3272,1,1,2,0.5,0.5
"3325",3273,1,1,2,0.5,0.5
"3326",3274,1,1,2,0.5,0.5
"3327",3275,1,1,2,0.5,0.5
"3328",3276,1,1,2,0.5,0.5
"3329",3277,1,1,2,0.5,0.5
"3330",3278,1,1,2,0.5,0.5
"3331",3279,1,1,2,0.5,0.5
"3332",3280,1,1,2,0.5,0.5
"3333",3281,1,1,2,0.5,0.5
"3334",3282,1,1,2,0.5,0.5
"3335",3283,1,1,2,0.5,0.5
"3336",3284,1,1,2,0.5,0.5
"3337",3285,1,1,2,0.5,0.5
"3338",3286,1,1,2,0.5,0.5
"3339",3287,1,1,2,0.5,0.5
"3340",3288,1,1,2,0.5,0.5
"3341",3289,1,1,2,0.5,0.5
"3342",3290,1,1,2,0.5,0.5
"3343",3291,1,1,2,0.5,0.5
"3344",3292,1,1,2,0.5,0.5
"3345",3293,1,1,2,0.5,0.5
"3346",3294,1,1,2,0.5,0.5
"3347",3295,1,1,2,0.5,0.5
"3348",3296,1,1,2,0.5,0.5
"3349",3297,1,1,2,0.5,0.5
"3350",3298,1,1,2,0.5,0.5
"3351",3299,1,1,2,0.5,0.5
"3352",3300,1,1,2,0.5,0.5
"3353",3301,1,1,2,0.5,0.5
"3354",3302,1,1,2,0.5,0.5
"3355",3303,1,1,2,0.5,0.5
"3356",3304,1,1,2,0.5,0.5
"3357",3305,1,1,2,0.5,0.5
"3358",3306,1,1,2,0.5,0.5
"3359",3307,1,1,2,0.5,0.5
"3360",3308,1,1,2,0.5,0.5
"3361",3309,1,1,2,0.5,0.5
"3362",3310,1,1,2,0.5,0.5
"3363",3311,1,1,2,0.5,0.5
"3364",3312,1,1,2,0.5,0.5
"3365",3313,1,1,2,0.5,0.5
"3366",3314,1,1,2,0.5,0.5
"3367",3315,1,1,2,0.5,0.5
"3368",3316,1,1,2,0.5,0.5
"3369",3317,1,1,2,0.5,0.5
"3370",3318,1,1,2,0.5,0.5
"3371",3319,1,1,2,0.5,0.5
"3372",3320,1,1,2,0.5,0.5
"3373",3321,1,1,2,0.5,0.5
"3374",3322,1,1,2,0.5,0.5
"3375",3323,1,1,2,0.5,0.5
"3376",3324,1,1,2,0.5,0.5
"3377",3325,1,1,2,0.5,0.5
"3378",3326,1,1,2,0.5,0.5
"3379",3327,1,1,2,0.5,0.5
"3380",3328,1,1,2,0.5,0.5
"3381",3329,1,1,2,0.5,0.5
"3382",3330,1,1,2,0.5,0.5
"3383",3331,1,1,2,0.5,0.5
"3384",3332,1,1,2,0.5,0.5
"3385",3333,1,1,2,0.5,0.5
"3386",3334,1,1,2,0.5,0.5
"3387",3335,1,1,2,0.5,0.5
"3388",3336,1,1,2,0.5,0.5
"3389",3337,1,1,2,0.5,0.5
"3390",3338,1,1,2,0.5,0.5
"3391",3339,1,1,2,0.5,0.5
"3392",3340,1,1,2,0.5,0.5
"3393",3341,1,1,2,0.5,0.5
"3394",3342,1,1,2,0.5,0.5
"3395",3343,1,1,2,0.5,0.5
"3396",3344,1,1,2,0.5,0.5
"3397",3345,1,1,2,0.5,0.5
"3398",3346,1,1,2,0.5,0.5
"3399",3347,1,1,2,0.5,0.5
"3400",3348,1,1,2,0.5,0.5
"3401",3349,1,1,2,0.5,0.5
"3402",3350,1,1,2,0.5,0.5
"3403",3351,1,1,2,0.5,0.5
"3404",3352,1,1,2,0.5,0.5
"3405",3353,1,1,2,0.5,0.5
"3406",3354,1,1,2,0.5,0.5
"3407",3355,1,1,2,0.5,0.5
"3408",3356,1,1,2,0.5,0.5
"3409",3357,1,1,2,0.5,0.5
"3410",3358,1,1,2,0.5,0.5
"3411",3359,1,1,2,0.5,0.5
"3412",3360,1,1,2,0.5,0.5
"3413",3361,1,1,2,0.5,0.5
"3414",3362,1,1,2,0.5,0.5
"3415",3363,1,1,2,0.5,0.5
"3416",3364,1,1,2,0.5,0.5
"3417",3365,1,1,2,0.5,0.5
"3418",3366,1,1,2,0.5,0.5
"3419",3367,1,1,2,0.5,0.5
"3420",3368,1,1,2,0.5,0.5
"3421",3369,1,1,2,0.5,0.5
"3422",3370,1,1,2,0.5,0.5
"3423",3371,1,1,2,0.5,0.5
"3424",3372,1,1,2,0.5,0.5
"3425",3373,1,1,2,0.5,0.5
"3426",3374,1,1,2,0.5,0.5
"3427",3375,1,1,2,0.5,0.5
"3428",3376,1,1,2,0.5,0.5
"3429",3377,1,1,2,0.5,0.5
"3430",3378,1,1,2,0.5,0.5
"3431",3379,1,1,2,0.5,0.5
"3432",3380,1,1,2,0.5,0.5
"3433",3381,1,1,2,0.5,0.5
"3434",3382,1,1,2,0.5,0.5
"3435",3383,1,1,2,0.5,0.5
"3436",3384,1,1,2,0.5,0.5
"3437",3385,1,1,2,0.5,0.5
"3438",3386,1,1,2,0.5,0.5
"3439",3387,1,1,2,0.5,0.5
"3440",3388,1,1,2,0.5,0.5
"3441",3389,1,1,2,0.5,0.5
"3442",3390,1,1,2,0.5,0.5
"3443",3391,1,1,2,0.5,0.5
"3444",3392,1,1,2,0.5,0.5
"3445",3393,1,1,2,0.5,0.5
"3446",3394,1,1,2,0.5,0.5
"3447",3395,1,1,2,0.5,0.5
"3448",3396,1,1,2,0.5,0.5
"3449",3397,1,1,2,0.5,0.5
"3450",3398,1,1,2,0.5,0.5
"3451",3399,1,1,2,0.5,0.5
"3452",3400,1,1,2,0.5,0.5
"3453",3401,1,1,2,0.5,0.5
"3454",3402,1,1,2,0.5,0.5
"3455",3403,1,1,2,0.5,0.5
"3456",3404,1,1,2,0.5,0.5
"3457",3405,1,1,2,0.5,0.5
"3458",3406,1,1,2,0.5,0.5
"3459",3407,1,1,2,0.5,0.5
"3460",3408,1,1,2,0.5,0.5
"3461",3409,1,1,2,0.5,0.5
"3462",3410,1,1,2,0.5,0.5
"3463",3411,1,1,2,0.5,0.5
"3464",3412,1,1,2,0.5,0.5
"3465",3413,1,1,2,0.5,0.5
"3466",3414,1,1,2,0.5,0.5
"3467",3415,1,1,2,0.5,0.5
"3468",3416,1,1,2,0.5,0.5
"3469",3417,1,1,2,0.5,0.5
"3470",3418,1,1,2,0.5,0.5
"3471",3419,1,1,2,0.5,0.5
"3472",3420,1,1,2,0.5,0.5
"3473",3421,1,1,2,0.5,0.5
"3474",3422,1,1,2,0.5,0.5
"3475",3423,1,1,2,0.5,0.5
"3476",3424,1,1,2,0.5,0.5
"3477",3425,1,1,2,0.5,0.5
"3478",3426,1,1,2,0.5,0.5
"3479",3427,1,1,2,0.5,0.5
"3480",3428,1,1,2,0.5,0.5
"3481",3429,1,1,2,0.5,0.5
"3482",3430,1,1,2,0.5,0.5
"3483",3431,1,1,2,0.5,0.5
"3484",3432,1,1,2,0.5,0.5
"3485",3433,1,1,2,0.5,0.5
"3486",3434,1,1,2,0.5,0.5
"3487",3435,1,1,2,0.5,0.5
"3488",3436,1,1,2,0.5,0.5
"3489",3437,1,1,2,0.5,0.5
"3490",3438,1,1,2,0.5,0.5
"3491",3439,1,1,2,0.5,0.5
"3492",3440,1,1,2,0.5,0.5
"3493",3441,1,1,2,0.5,0.5
"3494",3442,1,1,2,0.5,0.5
"3495",3443,1,1,2,0.5,0.5
"3496",3444,1,1,2,0.5,0.5
"3497",3445,1,1,2,0.5,0.5
"3498",3446,1,1,2,0.5,0.5
"3499",3447,1,1,2,0.5,0.5
"3500",3448,1,1,2,0.5,0.5
"3501",3449,1,1,2,0.5,0.5
"3502",3450,1,1,2,0.5,0.5
"3503",3451,1,1,2,0.5,0.5
"3504",3452,1,1,2,0.5,0.5
"3505",3453,1,1,2,0.5,0.5
"3506",3454,1,1,2,0.5,0.5
"3507",3455,1,1,2,0.5,0.5
"3508",3456,1,1,2,0.5,0.5
"3509",3457,1,1,2,0.5,0.5
"3510",3458,1,1,2,0.5,0.5
"3511",3459,1,1,2,0.5,0.5
"3512",3460,1,1,2,0.5,0.5
"3513",3461,1,1,2,0.5,0.5
"3514",3462,1,1,2,0.5,0.5
"3515",3463,1,1,2,0.5,0.5
"3516",3464,1,1,2,0.5,0.5
"3517",3465,1,1,2,0.5,0.5
"3518",3466,1,1,2,0.5,0.5
"3519",3467,1,1,2,0.5,0.5
"3520",3468,1,1,2,0.5,0.5
"3521",3469,1,1,2,0.5,0.5
"3522",3470,1,1,2,0.5,0.5
"3523",3471,1,1,2,0.5,0.5
"3524",3472,1,1,2,0.5,0.5
"3525",3473,1,1,2,0.5,0.5
"3526",3474,1,1,2,0.5,0.5
"3527",3475,1,1,2,0.5,0.5
"3528",3476,1,1,2,0.5,0.5
"3529",3477,1,1,2,0.5,0.5
"3530",3478,1,1,2,0.5,0.5
"3531",3479,1,1,2,0.5,0.5
"3532",3480,1,1,2,0.5,0.5
"3533",3481,1,1,2,0.5,0.5
"3534",3482,1,1,2,0.5,0.5
"3535",3483,1,1,2,0.5,0.5
"3536",3484,1,1,2,0.5,0.5
"3537",3485,1,1,2,0.5,0.5
"3538",3486,1,1,2,0.5,0.5
"3539",3487,1,1,2,0.5,0.5
"3540",3488,1,1,2,0.5,0.5
"3541",3489,1,1,2,0.5,0.5
"3542",3490,1,1,2,0.5,0.5
"3543",3491,1,1,2,0.5,0.5
"3544",3492,1,1,2,0.5,0.5
"3545",3493,1,1,2,0.5,0.5
"3546",3494,1,1,2,0.5,0.5
"3547",3495,1,1,2,0.5,0.5
"3548",3496,1,1,2,0.5,0.5
"3549",3497,1,1,2,0.5,0.5
"3550",3498,1,1,2,0.5,0.5
"3551",3499,1,1,2,0.5,0.5
"3552",3500,1,1,2,0.5,0.5
"3553",3501,1,1,2,0.5,0.5
"3554",3502,1,1,2,0.5,0.5
"3555",3503,1,1,2,0.5,0.5
"3556",3504,1,1,2,0.5,0.5
"3557",3505,1,1,2,0.5,0.5
"3558",3506,1,1,2,0.5,0.5
"3559",3507,1,1,2,0.5,0.5
"3560",3508,1,1,2,0.5,0.5
"3561",3509,1,1,2,0.5,0.5
"3562",3510,1,1,2,0.5,0.5
"3563",3511,1,1,2,0.5,0.5
"3564",3512,1,1,2,0.5,0.5
"3565",3513,1,1,2,0.5,0.5
"3566",3514,1,1,2,0.5,0.5
"3567",3515,1,1,2,0.5,0.5
"3568",3516,1,1,2,0.5,0.5
"3569",3517,1,1,2,0.5,0.5
"3570",3518,1,1,2,0.5,0.5
"3571",3519,1,1,2,0.5,0.5
"3572",3521,1,1,2,0.5,0.5
"3573",3522,1,1,2,0.5,0.5
"3574",3523,1,1,2,0.5,0.5
"3575",3524,1,1,2,0.5,0.5
"3576",3525,1,1,2,0.5,0.5
"3577",3526,1,1,2,0.5,0.5
"3578",3527,1,1,2,0.5,0.5
"3579",3528,1,1,2,0.5,0.5
"3580",3529,1,1,2,0.5,0.5
"3581",3530,1,1,2,0.5,0.5
"3582",3531,1,1,2,0.5,0.5
"3583",3532,1,1,2,0.5,0.5
"3584",3533,1,1,2,0.5,0.5
"3585",3534,1,1,2,0.5,0.5
"3586",3535,1,1,2,0.5,0.5
"3587",3536,1,1,2,0.5,0.5
"3588",3537,1,1,2,0.5,0.5
"3589",3538,1,1,2,0.5,0.5
"3590",3539,1,1,2,0.5,0.5
"3591",3540,1,1,2,0.5,0.5
"3592",3541,1,1,2,0.5,0.5
"3593",3542,1,1,2,0.5,0.5
"3594",3543,1,1,2,0.5,0.5
"3595",3544,1,1,2,0.5,0.5
"3596",3545,1,1,2,0.5,0.5
"3597",3546,1,1,2,0.5,0.5
"3598",3547,1,1,2,0.5,0.5
"3599",3548,1,1,2,0.5,0.5
"3600",3549,1,1,2,0.5,0.5
"3601",3550,1,1,2,0.5,0.5
"3602",3551,1,1,2,0.5,0.5
"3603",3552,1,1,2,0.5,0.5
"3604",3553,1,1,2,0.5,0.5
"3605",3554,1,1,2,0.5,0.5
"3606",3555,1,1,2,0.5,0.5
"3607",3556,1,1,2,0.5,0.5
"3608",3557,1,1,2,0.5,0.5
"3609",3558,1,1,2,0.5,0.5
"3610",3559,1,1,2,0.5,0.5
"3611",3560,1,1,2,0.5,0.5
"3612",3561,1,1,2,0.5,0.5
"3613",3562,1,1,2,0.5,0.5
"3614",3563,1,1,2,0.5,0.5
"3615",3564,1,1,2,0.5,0.5
"3616",3565,1,1,2,0.5,0.5
"3617",3566,1,1,2,0.5,0.5
"3618",3567,1,1,2,0.5,0.5
"3619",3568,1,1,2,0.5,0.5
"3620",3569,1,1,2,0.5,0.5
"3621",3570,1,1,2,0.5,0.5
"3622",3571,1,1,2,0.5,0.5
"3623",3572,1,1,2,0.5,0.5
"3624",3573,1,1,2,0.5,0.5
"3625",3574,1,1,2,0.5,0.5
"3626",3575,1,1,2,0.5,0.5
"3627",3576,1,1,2,0.5,0.5
"3628",3577,1,1,2,0.5,0.5
"3629",3578,1,1,2,0.5,0.5
"3630",3579,1,1,2,0.5,0.5
"3631",3580,1,1,2,0.5,0.5
"3632",3581,1,1,2,0.5,0.5
"3633",3582,1,1,2,0.5,0.5
"3634",3583,1,1,2,0.5,0.5
"3635",3584,1,1,2,0.5,0.5
"3636",3585,1,1,2,0.5,0.5
"3637",3586,1,1,2,0.5,0.5
"3638",3587,1,1,2,0.5,0.5
"3639",3588,1,1,2,0.5,0.5
"3640",3589,1,1,2,0.5,0.5
"3641",3590,1,1,2,0.5,0.5
"3642",3591,1,1,2,0.5,0.5
"3643",3592,1,1,2,0.5,0.5
"3644",3593,1,1,2,0.5,0.5
"3645",3594,1,1,2,0.5,0.5
"3646",3595,1,1,2,0.5,0.5
"3647",3596,1,1,2,0.5,0.5
"3648",3597,1,1,2,0.5,0.5
"3649",3598,1,1,2,0.5,0.5
"3650",3599,1,1,2,0.5,0.5
"3651",3600,1,1,2,0.5,0.5
"3652",3601,1,1,2,0.5,0.5
"3653",3602,1,1,2,0.5,0.5
"3654",3603,1,1,2,0.5,0.5
"3655",3604,1,1,2,0.5,0.5
"3656",3605,1,1,2,0.5,0.5
"3657",3606,1,1,2,0.5,0.5
"3658",3607,1,1,2,0.5,0.5
"3659",3608,1,1,2,0.5,0.5
"3660",3609,1,1,2,0.5,0.5
"3661",3610,1,1,2,0.5,0.5
"3662",3611,1,1,2,0.5,0.5
"3663",3612,1,1,2,0.5,0.5
"3664",3613,1,1,2,0.5,0.5
"3665",3614,1,1,2,0.5,0.5
"3666",3615,1,1,2,0.5,0.5
"3667",3616,1,1,2,0.5,0.5
"3668",3617,1,1,2,0.5,0.5
"3669",3618,1,1,2,0.5,0.5
"3670",3619,1,1,2,0.5,0.5
"3671",3620,1,1,2,0.5,0.5
"3672",3621,1,1,2,0.5,0.5
"3673",3622,1,1,2,0.5,0.5
"3674",3623,1,1,2,0.5,0.5
"3675",3624,1,1,2,0.5,0.5
"3676",3625,1,1,2,0.5,0.5
"3677",3626,1,1,2,0.5,0.5
"3678",3627,1,1,2,0.5,0.5
"3679",3628,1,1,2,0.5,0.5
"3680",3629,1,1,2,0.5,0.5
"3681",3630,1,1,2,0.5,0.5
"3682",3631,1,1,2,0.5,0.5
"3683",3632,1,1,2,0.5,0.5
"3684",3633,1,1,2,0.5,0.5
"3685",3634,1,1,2,0.5,0.5
"3686",3635,1,1,2,0.5,0.5
"3687",3636,1,1,2,0.5,0.5
"3688",3637,1,1,2,0.5,0.5
"3689",3638,1,1,2,0.5,0.5
"3690",3639,1,1,2,0.5,0.5
"3691",3640,1,1,2,0.5,0.5
"3692",3641,1,1,2,0.5,0.5
"3693",3642,1,1,2,0.5,0.5
"3694",3643,1,1,2,0.5,0.5
"3695",3644,1,1,2,0.5,0.5
"3696",3645,1,1,2,0.5,0.5
"3697",3646,1,1,2,0.5,0.5
"3698",3647,1,1,2,0.5,0.5
"3699",3648,1,1,2,0.5,0.5
"3700",3649,1,1,2,0.5,0.5
"3701",3650,1,1,2,0.5,0.5
"3702",3651,1,1,2,0.5,0.5
"3703",3652,1,1,2,0.5,0.5
"3704",3653,1,1,2,0.5,0.5
"3705",3654,1,1,2,0.5,0.5
"3706",3655,1,1,2,0.5,0.5
"3707",3656,1,1,2,0.5,0.5
"3708",3657,1,1,2,0.5,0.5
"3709",3658,1,1,2,0.5,0.5
"3710",3659,1,1,2,0.5,0.5
"3711",3660,1,1,2,0.5,0.5
"3712",3661,1,1,2,0.5,0.5
"3713",3662,1,1,2,0.5,0.5
"3714",3663,1,1,2,0.5,0.5
"3715",3664,1,1,2,0.5,0.5
"3716",3665,1,1,2,0.5,0.5
"3717",3666,1,1,2,0.5,0.5
"3718",3667,1,1,2,0.5,0.5
"3719",3668,1,1,2,0.5,0.5
"3720",3669,1,1,2,0.5,0.5
"3721",3670,1,1,2,0.5,0.5
"3722",3671,1,1,2,0.5,0.5
"3723",3672,1,1,2,0.5,0.5
"3724",3673,1,1,2,0.5,0.5
"3725",3674,1,1,2,0.5,0.5
"3726",3675,1,1,2,0.5,0.5
"3727",3676,1,1,2,0.5,0.5
"3728",3677,1,1,2,0.5,0.5
"3729",3678,1,1,2,0.5,0.5
"3730",3679,1,1,2,0.5,0.5
"3731",3680,1,1,2,0.5,0.5
"3732",3681,1,1,2,0.5,0.5
"3733",3682,1,1,2,0.5,0.5
"3734",3683,1,1,2,0.5,0.5
"3735",3684,1,1,2,0.5,0.5
"3736",3685,1,1,2,0.5,0.5
"3737",3686,1,1,2,0.5,0.5
"3738",3687,1,1,2,0.5,0.5
"3739",3688,1,1,2,0.5,0.5
"3740",3689,1,1,2,0.5,0.5
"3741",3690,1,1,2,0.5,0.5
"3742",3691,1,1,2,0.5,0.5
"3743",3692,1,1,2,0.5,0.5
"3744",3693,1,1,2,0.5,0.5
"3745",3694,1,1,2,0.5,0.5
"3746",3695,1,1,2,0.5,0.5
"3747",3697,1,1,2,0.5,0.5
"3748",3698,1,1,2,0.5,0.5
"3749",3699,1,1,2,0.5,0.5
"3750",3700,1,1,2,0.5,0.5
"3751",3701,1,1,2,0.5,0.5
"3752",3702,1,1,2,0.5,0.5
"3753",3703,1,1,2,0.5,0.5
"3754",3704,1,1,2,0.5,0.5
"3755",3705,1,1,2,0.5,0.5
"3756",3706,1,1,2,0.5,0.5
"3757",3707,1,1,2,0.5,0.5
"3758",3708,1,1,2,0.5,0.5
"3759",3709,1,1,2,0.5,0.5
"3760",3710,1,1,2,0.5,0.5
"3761",3711,1,1,2,0.5,0.5
"3762",3712,1,1,2,0.5,0.5
"3763",3713,1,1,2,0.5,0.5
"3764",3714,1,1,2,0.5,0.5
"3765",3715,1,1,2,0.5,0.5
"3766",3716,1,1,2,0.5,0.5
"3767",3717,1,1,2,0.5,0.5
"3768",3718,1,1,2,0.5,0.5
"3769",3719,1,1,2,0.5,0.5
"3770",3720,1,1,2,0.5,0.5
"3771",3721,1,1,2,0.5,0.5
"3772",3722,1,1,2,0.5,0.5
"3773",3723,1,1,2,0.5,0.5
"3774",3724,1,1,2,0.5,0.5
"3775",3725,1,1,2,0.5,0.5
"3776",3726,1,1,2,0.5,0.5
"3777",3727,1,1,2,0.5,0.5
"3778",3728,1,1,2,0.5,0.5
"3779",3729,1,1,2,0.5,0.5
"3780",3730,1,1,2,0.5,0.5
"3781",3731,1,1,2,0.5,0.5
"3782",3732,1,1,2,0.5,0.5
"3783",3733,1,1,2,0.5,0.5
"3784",3734,1,1,2,0.5,0.5
"3785",3735,1,1,2,0.5,0.5
"3786",3736,1,1,2,0.5,0.5
"3787",3737,1,1,2,0.5,0.5
"3788",3738,1,1,2,0.5,0.5
"3789",3739,1,1,2,0.5,0.5
"3790",3740,1,1,2,0.5,0.5
"3791",3741,1,1,2,0.5,0.5
"3792",3742,1,1,2,0.5,0.5
"3793",3743,1,1,2,0.5,0.5
"3794",3744,1,1,2,0.5,0.5
"3795",3745,1,1,2,0.5,0.5
"3796",3746,1,1,2,0.5,0.5
"3797",3747,1,1,2,0.5,0.5
"3798",3748,1,1,2,0.5,0.5
"3799",3749,1,1,2,0.5,0.5
"3800",3750,1,1,2,0.5,0.5
"3801",3751,1,1,2,0.5,0.5
"3802",3752,1,1,2,0.5,0.5
"3803",3753,1,1,2,0.5,0.5
"3804",3754,1,1,2,0.5,0.5
"3805",3755,1,1,2,0.5,0.5
"3806",3756,1,1,2,0.5,0.5
"3807",3757,1,1,2,0.5,0.5
"3808",3758,1,1,2,0.5,0.5
"3809",3759,1,1,2,0.5,0.5
"3810",3760,1,1,2,0.5,0.5
"3811",3761,1,1,2,0.5,0.5
"3812",3762,1,1,2,0.5,0.5
"3813",3763,1,1,2,0.5,0.5
"3814",3764,1,1,2,0.5,0.5
"3815",3765,1,1,2,0.5,0.5
"3816",3766,1,1,2,0.5,0.5
"3817",3767,1,1,2,0.5,0.5
"3818",3768,1,1,2,0.5,0.5
"3819",3769,1,1,2,0.5,0.5
"3820",3770,1,1,2,0.5,0.5
"3821",3771,1,1,2,0.5,0.5
"3822",3772,1,1,2,0.5,0.5
"3823",3773,1,1,2,0.5,0.5
"3824",3774,1,1,2,0.5,0.5
"3825",3775,1,1,2,0.5,0.5
"3826",3776,1,1,2,0.5,0.5
"3827",3777,1,1,2,0.5,0.5
"3828",3778,1,1,2,0.5,0.5
"3829",3779,1,1,2,0.5,0.5
"3830",3780,1,1,2,0.5,0.5
"3831",3781,1,1,2,0.5,0.5
"3832",3782,1,1,2,0.5,0.5
"3833",3783,1,1,2,0.5,0.5
"3834",3784,1,1,2,0.5,0.5
"3835",3785,1,1,2,0.5,0.5
"3836",3786,1,1,2,0.5,0.5
"3837",3787,1,1,2,0.5,0.5
"3838",3788,1,1,2,0.5,0.5
"3839",3789,1,1,2,0.5,0.5
"3840",3790,1,1,2,0.5,0.5
"3841",3791,1,1,2,0.5,0.5
"3842",3792,1,1,2,0.5,0.5
"3843",3793,1,1,2,0.5,0.5
"3844",3794,1,1,2,0.5,0.5
"3845",3795,1,1,2,0.5,0.5
"3846",3796,1,1,2,0.5,0.5
"3847",3797,1,1,2,0.5,0.5
"3848",3798,1,1,2,0.5,0.5
"3849",3799,1,1,2,0.5,0.5
"3850",3800,1,1,2,0.5,0.5
"3851",3801,1,1,2,0.5,0.5
"3852",3802,1,1,2,0.5,0.5
"3853",3803,1,1,2,0.5,0.5
"3854",3804,1,1,2,0.5,0.5
"3855",3805,1,1,2,0.5,0.5
"3856",3806,1,1,2,0.5,0.5
"3857",3807,1,1,2,0.5,0.5
"3858",3808,1,1,2,0.5,0.5
"3859",3809,1,1,2,0.5,0.5
"3860",3810,1,1,2,0.5,0.5
"3861",3811,1,1,2,0.5,0.5
"3862",3812,1,1,2,0.5,0.5
"3863",3813,1,1,2,0.5,0.5
"3864",3814,1,1,2,0.5,0.5
"3865",3815,1,1,2,0.5,0.5
"3866",3816,1,1,2,0.5,0.5
"3867",3817,1,1,2,0.5,0.5
"3868",3818,1,1,2,0.5,0.5
"3869",3819,1,1,2,0.5,0.5
"3870",3820,1,1,2,0.5,0.5
"3871",3821,1,1,2,0.5,0.5
"3872",3822,1,1,2,0.5,0.5
"3873",3823,1,1,2,0.5,0.5
"3874",3824,1,1,2,0.5,0.5
"3875",3825,1,1,2,0.5,0.5
"3876",3826,1,1,2,0.5,0.5
"3877",3827,1,1,2,0.5,0.5
"3878",3828,1,1,2,0.5,0.5
"3879",3829,1,1,2,0.5,0.5
"3880",3830,1,1,2,0.5,0.5
"3881",3831,1,1,2,0.5,0.5
"3882",3832,1,1,2,0.5,0.5
"3883",3833,1,1,2,0.5,0.5
"3884",3834,1,1,2,0.5,0.5
"3885",3835,1,1,2,0.5,0.5
"3886",3836,1,1,2,0.5,0.5
"3887",3837,1,1,2,0.5,0.5
"3888",3838,1,1,2,0.5,0.5
"3889",3839,1,1,2,0.5,0.5
"3890",3840,1,1,2,0.5,0.5
"3891",3841,1,1,2,0.5,0.5
"3892",3842,1,1,2,0.5,0.5
"3893",3843,1,1,2,0.5,0.5
"3894",3844,1,1,2,0.5,0.5
"3895",3845,1,1,2,0.5,0.5
"3896",3846,1,1,2,0.5,0.5
"3897",3847,1,1,2,0.5,0.5
"3898",3848,1,1,2,0.5,0.5
"3899",3849,1,1,2,0.5,0.5
"3900",3850,1,1,2,0.5,0.5
"3901",3851,1,1,2,0.5,0.5
"3902",3852,1,1,2,0.5,0.5
"3903",3853,1,1,2,0.5,0.5
"3904",3854,1,1,2,0.5,0.5
"3905",3855,1,1,2,0.5,0.5
"3906",3856,1,1,2,0.5,0.5
"3907",3857,1,1,2,0.5,0.5
"3908",3858,1,1,2,0.5,0.5
"3909",3859,1,1,2,0.5,0.5
"3910",3860,1,1,2,0.5,0.5
"3911",3861,1,1,2,0.5,0.5
"3912",3862,1,1,2,0.5,0.5
"3913",3863,1,1,2,0.5,0.5
"3914",3864,1,1,2,0.5,0.5
"3915",3865,1,1,2,0.5,0.5
"3916",3866,1,1,2,0.5,0.5
"3917",3867,1,1,2,0.5,0.5
"3918",3868,1,1,2,0.5,0.5
"3919",3869,1,1,2,0.5,0.5
"3920",3870,1,1,2,0.5,0.5
"3921",3871,1,1,2,0.5,0.5
"3922",3872,1,1,2,0.5,0.5
"3923",3873,1,1,2,0.5,0.5
"3924",3874,1,1,2,0.5,0.5
"3925",3875,1,1,2,0.5,0.5
"3926",3876,1,1,2,0.5,0.5
"3927",3877,1,1,2,0.5,0.5
"3928",3878,1,1,2,0.5,0.5
"3929",3879,1,1,2,0.5,0.5
"3930",3880,1,1,2,0.5,0.5
"3931",3881,1,1,2,0.5,0.5
"3932",3882,1,1,2,0.5,0.5
"3933",3883,1,1,2,0.5,0.5
"3934",3884,1,1,2,0.5,0.5
"3935",3885,1,1,2,0.5,0.5
"3936",3886,1,1,2,0.5,0.5
"3937",3887,1,1,2,0.5,0.5
"3938",3888,1,1,2,0.5,0.5
"3939",3890,1,1,2,0.5,0.5
"3940",3891,1,1,2,0.5,0.5
"3941",3892,1,1,2,0.5,0.5
"3942",3893,1,1,2,0.5,0.5
"3943",3894,1,1,2,0.5,0.5
"3944",3895,1,1,2,0.5,0.5
"3945",3896,1,1,2,0.5,0.5
"3946",3897,1,1,2,0.5,0.5
"3947",3898,1,1,2,0.5,0.5
"3948",3899,1,1,2,0.5,0.5
"3949",3900,1,1,2,0.5,0.5
"3950",3901,1,1,2,0.5,0.5
"3951",3902,1,1,2,0.5,0.5
"3952",3903,1,1,2,0.5,0.5
"3953",3904,1,1,2,0.5,0.5
"3954",3905,1,1,2,0.5,0.5
"3955",3906,1,1,2,0.5,0.5
"3956",3907,1,1,2,0.5,0.5
"3957",3908,1,1,2,0.5,0.5
"3958",3909,1,1,2,0.5,0.5
"3959",3910,1,1,2,0.5,0.5
"3960",3911,1,1,2,0.5,0.5
"3961",3912,1,1,2,0.5,0.5
"3962",3913,1,1,2,0.5,0.5
"3963",3914,1,1,2,0.5,0.5
"3964",3915,1,1,2,0.5,0.5
"3965",3916,1,1,2,0.5,0.5
"3966",3917,1,1,2,0.5,0.5
"3967",3918,1,1,2,0.5,0.5
"3968",3919,1,1,2,0.5,0.5
"3969",3920,1,1,2,0.5,0.5
"3970",3921,1,1,2,0.5,0.5
"3971",3922,1,1,2,0.5,0.5
"3972",3923,1,1,2,0.5,0.5
"3973",3924,1,1,2,0.5,0.5
"3974",3925,1,1,2,0.5,0.5
"3975",3926,1,1,2,0.5,0.5
"3976",3927,1,1,2,0.5,0.5
"3977",3928,1,1,2,0.5,0.5
"3978",3929,1,1,2,0.5,0.5
"3979",3930,1,1,2,0.5,0.5
"3980",3931,1,1,2,0.5,0.5
"3981",3932,1,1,2,0.5,0.5
"3982",3933,1,1,2,0.5,0.5
"3983",3934,1,1,2,0.5,0.5
"3984",3935,1,1,2,0.5,0.5
"3985",3936,1,1,2,0.5,0.5
"3986",3937,1,1,2,0.5,0.5
"3987",3938,1,1,2,0.5,0.5
"3988",3939,1,1,2,0.5,0.5
"3989",3940,1,1,2,0.5,0.5
"3990",3941,1,1,2,0.5,0.5
"3991",3942,1,1,2,0.5,0.5
"3992",3943,1,1,2,0.5,0.5
"3993",3944,1,1,2,0.5,0.5
"3994",3945,1,1,2,0.5,0.5
"3995",3946,1,1,2,0.5,0.5
"3996",3947,1,1,2,0.5,0.5
"3997",3948,1,1,2,0.5,0.5
"3998",3949,1,1,2,0.5,0.5
"3999",3950,1,1,2,0.5,0.5
"4000",3951,1,1,2,0.5,0.5
"4001",3952,1,1,2,0.5,0.5
"4002",3953,1,1,2,0.5,0.5
"4003",3954,1,1,2,0.5,0.5
"4004",3955,1,1,2,0.5,0.5
"4005",3956,1,1,2,0.5,0.5
"4006",3957,1,1,2,0.5,0.5
"4007",3958,1,1,2,0.5,0.5
"4008",3959,1,1,2,0.5,0.5
"4009",3960,1,1,2,0.5,0.5
"4010",3961,1,1,2,0.5,0.5
"4011",3962,1,1,2,0.5,0.5
"4012",3963,1,1,2,0.5,0.5
"4013",3964,1,1,2,0.5,0.5
"4014",3965,1,1,2,0.5,0.5
"4015",3966,1,1,2,0.5,0.5
"4016",3967,1,1,2,0.5,0.5
"4017",3968,1,1,2,0.5,0.5
"4018",3969,1,1,2,0.5,0.5
"4019",3970,1,1,2,0.5,0.5
"4020",3971,1,1,2,0.5,0.5
"4021",3972,1,1,2,0.5,0.5
"4022",3973,1,1,2,0.5,0.5
"4023",3974,1,1,2,0.5,0.5
"4024",3975,1,1,2,0.5,0.5
"4025",3976,1,1,2,0.5,0.5
"4026",3977,1,1,2,0.5,0.5
"4027",3978,1,1,2,0.5,0.5
"4028",3979,1,1,2,0.5,0.5
"4029",3980,1,1,2,0.5,0.5
"4030",3981,1,1,2,0.5,0.5
"4031",3982,1,1,2,0.5,0.5
"4032",3983,1,1,2,0.5,0.5
"4033",3984,1,1,2,0.5,0.5
"4034",3985,1,1,2,0.5,0.5
"4035",3986,1,1,2,0.5,0.5
"4036",3987,1,1,2,0.5,0.5
"4037",3988,1,1,2,0.5,0.5
"4038",3989,1,1,2,0.5,0.5
"4039",3990,1,1,2,0.5,0.5
"4040",3991,1,1,2,0.5,0.5
"4041",3992,1,1,2,0.5,0.5
"4042",3993,1,1,2,0.5,0.5
"4043",3994,1,1,2,0.5,0.5
"4044",3995,1,1,2,0.5,0.5
"4045",3996,1,1,2,0.5,0.5
"4046",3997,1,1,2,0.5,0.5
"4047",3998,1,1,2,0.5,0.5
"4048",3999,1,1,2,0.5,0.5
"4049",4000,1,1,2,0.5,0.5
"4050",4001,1,1,2,0.5,0.5
"4051",4002,1,1,2,0.5,0.5
"4052",4003,1,1,2,0.5,0.5
"4053",4004,1,1,2,0.5,0.5
"4054",4005,1,1,2,0.5,0.5
"4055",4006,1,1,2,0.5,0.5
"4056",4007,1,1,2,0.5,0.5
"4057",4008,1,1,2,0.5,0.5
"4058",4009,1,1,2,0.5,0.5
"4059",4010,1,1,2,0.5,0.5
"4060",4011,1,1,2,0.5,0.5
"4061",4012,1,1,2,0.5,0.5
"4062",4013,1,1,2,0.5,0.5
"4063",4014,1,1,2,0.5,0.5
"4064",4015,1,1,2,0.5,0.5
"4065",4016,1,1,2,0.5,0.5
"4066",4017,1,1,2,0.5,0.5
"4067",4018,1,1,2,0.5,0.5
"4068",4019,1,1,2,0.5,0.5
"4069",4020,1,1,2,0.5,0.5
"4070",4021,1,1,2,0.5,0.5
"4071",4022,1,1,2,0.5,0.5
"4072",4023,1,1,2,0.5,0.5
"4073",4024,1,1,2,0.5,0.5
"4074",4025,1,1,2,0.5,0.5
"4075",4026,1,1,2,0.5,0.5
"4076",4027,1,1,2,0.5,0.5
"4077",4028,1,1,2,0.5,0.5
"4078",4029,1,1,2,0.5,0.5
"4079",4030,1,1,2,0.5,0.5
"4080",4031,1,1,2,0.5,0.5
"4081",4032,1,1,2,0.5,0.5
"4082",4033,1,1,2,0.5,0.5
"4083",4034,1,1,2,0.5,0.5
"4084",4035,1,1,2,0.5,0.5
"4085",4036,1,1,2,0.5,0.5
"4086",4037,1,1,2,0.5,0.5
"4087",4038,1,1,2,0.5,0.5
"4088",4039,1,1,2,0.5,0.5
"4089",4040,1,1,2,0.5,0.5
"4090",4041,1,1,2,0.5,0.5
"4091",4042,1,1,2,0.5,0.5
"4092",4043,1,1,2,0.5,0.5
"4093",4044,1,1,2,0.5,0.5
"4094",4045,1,1,2,0.5,0.5
"4095",4046,1,1,2,0.5,0.5
"4096",4047,1,1,2,0.5,0.5
"4097",4048,1,1,2,0.5,0.5
"4098",4049,1,1,2,0.5,0.5
"4099",4050,1,1,2,0.5,0.5
"4100",4051,1,1,2,0.5,0.5
"4101",4052,1,1,2,0.5,0.5
"4102",4053,1,1,2,0.5,0.5
"4103",4054,1,1,2,0.5,0.5
"4104",4055,1,1,2,0.5,0.5
"4105",4056,1,1,2,0.5,0.5
"4106",4057,1,1,2,0.5,0.5
"4107",4058,1,1,2,0.5,0.5
"4108",4059,1,1,2,0.5,0.5
"4109",4060,1,1,2,0.5,0.5
"4110",4061,1,1,2,0.5,0.5
"4111",4062,1,1,2,0.5,0.5
"4112",4063,1,1,2,0.5,0.5
"4113",4064,1,1,2,0.5,0.5
"4114",4065,1,1,2,0.5,0.5
"4115",4066,1,1,2,0.5,0.5
"4116",4067,1,1,2,0.5,0.5
"4117",4068,1,1,2,0.5,0.5
"4118",4069,1,1,2,0.5,0.5
"4119",4070,1,1,2,0.5,0.5
"4120",4071,1,1,2,0.5,0.5
"4121",4072,1,1,2,0.5,0.5
"4122",4073,1,1,2,0.5,0.5
"4123",4074,1,1,2,0.5,0.5
"4124",4075,1,1,2,0.5,0.5
"4125",4076,1,1,2,0.5,0.5
"4126",4077,1,1,2,0.5,0.5
"4127",4078,1,1,2,0.5,0.5
"4128",4079,1,1,2,0.5,0.5
"4129",4080,1,1,2,0.5,0.5
"4130",4081,1,1,2,0.5,0.5
"4131",4082,1,1,2,0.5,0.5
"4132",4083,1,1,2,0.5,0.5
"4133",4084,1,1,2,0.5,0.5
"4134",4085,1,1,2,0.5,0.5
"4135",4086,1,1,2,0.5,0.5
"4136",4087,1,1,2,0.5,0.5
"4137",4088,1,1,2,0.5,0.5
"4138",4089,1,1,2,0.5,0.5
"4139",4090,1,1,2,0.5,0.5
"4140",4091,1,1,2,0.5,0.5
"4141",4092,1,1,2,0.5,0.5
"4142",4093,1,1,2,0.5,0.5
"4143",4094,1,1,2,0.5,0.5
"4144",4095,1,1,2,0.5,0.5
"4145",4096,1,1,2,0.5,0.5
"4146",4097,1,1,2,0.5,0.5
"4147",4098,1,1,2,0.5,0.5
"4148",4099,1,1,2,0.5,0.5
"4149",4100,1,1,2,0.5,0.5
"4150",4101,1,1,2,0.5,0.5
"4151",4102,1,1,2,0.5,0.5
"4152",4103,1,1,2,0.5,0.5
"4153",4104,1,1,2,0.5,0.5
"4154",4105,1,1,2,0.5,0.5
"4155",4106,1,1,2,0.5,0.5
"4156",4107,1,1,2,0.5,0.5
"4157",4108,1,1,2,0.5,0.5
"4158",4109,1,1,2,0.5,0.5
"4159",4110,1,1,2,0.5,0.5
"4160",4111,1,1,2,0.5,0.5
"4161",4112,1,1,2,0.5,0.5
"4162",4113,1,1,2,0.5,0.5
"4163",4114,1,1,2,0.5,0.5
"4164",4115,1,1,2,0.5,0.5
"4165",4116,1,1,2,0.5,0.5
"4166",4117,1,1,2,0.5,0.5
"4167",4118,1,1,2,0.5,0.5
"4168",4119,1,1,2,0.5,0.5
"4169",4120,1,1,2,0.5,0.5
"4170",4121,1,1,2,0.5,0.5
"4171",4122,1,1,2,0.5,0.5
"4172",4123,1,1,2,0.5,0.5
"4173",4124,1,1,2,0.5,0.5
"4174",4125,1,1,2,0.5,0.5
"4175",4126,1,1,2,0.5,0.5
"4176",4127,1,1,2,0.5,0.5
"4177",4128,1,1,2,0.5,0.5
"4178",4129,1,1,2,0.5,0.5
"4179",4130,1,1,2,0.5,0.5
"4180",4131,1,1,2,0.5,0.5
"4181",4132,1,1,2,0.5,0.5
"4182",4133,1,1,2,0.5,0.5
"4183",4134,1,1,2,0.5,0.5
"4184",4135,1,1,2,0.5,0.5
"4185",4136,1,1,2,0.5,0.5
"4186",4137,1,1,2,0.5,0.5
"4187",4138,1,1,2,0.5,0.5
"4188",4139,1,1,2,0.5,0.5
"4189",4140,1,1,2,0.5,0.5
"4190",4141,1,1,2,0.5,0.5
"4191",4142,1,1,2,0.5,0.5
"4192",4143,1,1,2,0.5,0.5
"4193",4144,1,1,2,0.5,0.5
"4194",4145,1,1,2,0.5,0.5
"4195",4146,1,1,2,0.5,0.5
"4196",4147,1,1,2,0.5,0.5
"4197",4148,1,1,2,0.5,0.5
"4198",4149,1,1,2,0.5,0.5
"4199",4150,1,1,2,0.5,0.5
"4200",4151,1,1,2,0.5,0.5
"4201",4152,1,1,2,0.5,0.5
"4202",4153,1,1,2,0.5,0.5
"4203",4154,1,1,2,0.5,0.5
"4204",4155,1,1,2,0.5,0.5
"4205",4156,1,1,2,0.5,0.5
"4206",4157,1,1,2,0.5,0.5
"4207",4158,1,1,2,0.5,0.5
"4208",4159,1,1,2,0.5,0.5
"4209",4160,1,1,2,0.5,0.5
"4210",4161,1,1,2,0.5,0.5
"4211",4162,1,1,2,0.5,0.5
"4212",4163,1,1,2,0.5,0.5
"4213",4164,1,1,2,0.5,0.5
"4214",4165,1,1,2,0.5,0.5
"4215",4166,1,1,2,0.5,0.5
"4216",4167,1,1,2,0.5,0.5
"4217",4168,1,1,2,0.5,0.5
"4218",4169,1,1,2,0.5,0.5
"4219",4170,1,1,2,0.5,0.5
"4220",4171,1,1,2,0.5,0.5
"4221",4172,1,1,2,0.5,0.5
"4222",4173,1,1,2,0.5,0.5
"4223",4174,1,1,2,0.5,0.5
"4224",4175,1,1,2,0.5,0.5
"4225",4176,1,1,2,0.5,0.5
"4226",4177,1,1,2,0.5,0.5
"4227",4178,1,1,2,0.5,0.5
"4228",4179,1,1,2,0.5,0.5
"4229",4180,1,1,2,0.5,0.5
"4230",4181,1,1,2,0.5,0.5
"4231",4182,1,1,2,0.5,0.5
"4232",4183,1,1,2,0.5,0.5
"4233",4184,1,1,2,0.5,0.5
"4234",4185,1,1,2,0.5,0.5
"4235",4186,1,1,2,0.5,0.5
"4236",4187,1,1,2,0.5,0.5
"4237",4188,1,1,2,0.5,0.5
"4238",4189,1,1,2,0.5,0.5
"4239",4190,1,1,2,0.5,0.5
"4240",4191,1,1,2,0.5,0.5
"4241",4192,1,1,2,0.5,0.5
"4242",4193,1,1,2,0.5,0.5
"4243",4194,1,1,2,0.5,0.5
"4244",4195,1,1,2,0.5,0.5
"4245",4196,1,1,2,0.5,0.5
"4246",4197,1,1,2,0.5,0.5
"4247",4198,1,1,2,0.5,0.5
"4248",4199,1,1,2,0.5,0.5
"4249",4200,1,1,2,0.5,0.5
"4250",4201,1,1,2,0.5,0.5
"4251",4202,1,1,2,0.5,0.5
"4252",4203,1,1,2,0.5,0.5
"4253",4204,1,1,2,0.5,0.5
"4254",4205,1,1,2,0.5,0.5
"4255",4206,1,1,2,0.5,0.5
"4256",4207,1,1,2,0.5,0.5
"4257",4208,1,1,2,0.5,0.5
"4258",4209,1,1,2,0.5,0.5
"4259",4210,1,1,2,0.5,0.5
"4260",4211,1,1,2,0.5,0.5
"4261",4212,1,1,2,0.5,0.5
"4262",4213,1,1,2,0.5,0.5
"4263",4214,1,1,2,0.5,0.5
"4264",4215,1,1,2,0.5,0.5
"4265",4216,1,1,2,0.5,0.5
"4266",4217,1,1,2,0.5,0.5
"4267",4218,1,1,2,0.5,0.5
"4268",4219,1,1,2,0.5,0.5
"4269",4220,1,1,2,0.5,0.5
"4270",4221,1,1,2,0.5,0.5
"4271",4222,1,1,2,0.5,0.5
"4272",4223,1,1,2,0.5,0.5
"4273",4224,1,1,2,0.5,0.5
"4274",4225,1,1,2,0.5,0.5
"4275",4226,1,1,2,0.5,0.5
"4276",4227,1,1,2,0.5,0.5
"4277",4228,1,1,2,0.5,0.5
"4278",4229,1,1,2,0.5,0.5
"4279",4230,1,1,2,0.5,0.5
"4280",4231,1,1,2,0.5,0.5
"4281",4232,1,1,2,0.5,0.5
"4282",4233,1,1,2,0.5,0.5
"4283",4234,1,1,2,0.5,0.5
"4284",4235,1,1,2,0.5,0.5
"4285",4236,1,1,2,0.5,0.5
"4286",4237,1,1,2,0.5,0.5
"4287",4238,1,1,2,0.5,0.5
"4288",4239,1,1,2,0.5,0.5
"4289",4240,1,1,2,0.5,0.5
"4290",4241,1,1,2,0.5,0.5
"4291",4242,1,1,2,0.5,0.5
"4292",4243,1,1,2,0.5,0.5
"4293",4244,1,1,2,0.5,0.5
"4294",4245,1,1,2,0.5,0.5
"4295",4246,1,1,2,0.5,0.5
"4296",4247,1,1,2,0.5,0.5
"4297",4248,1,1,2,0.5,0.5
"4298",4249,1,1,2,0.5,0.5
"4299",4250,1,1,2,0.5,0.5
"4300",4251,1,1,2,0.5,0.5
"4301",4252,1,1,2,0.5,0.5
"4302",4253,1,1,2,0.5,0.5
"4303",4254,1,1,2,0.5,0.5
"4304",4255,1,1,2,0.5,0.5
"4305",4256,1,1,2,0.5,0.5
"4306",4257,1,1,2,0.5,0.5
"4307",4258,1,1,2,0.5,0.5
"4308",4259,1,1,2,0.5,0.5
"4309",4260,1,1,2,0.5,0.5
"4310",4261,1,1,2,0.5,0.5
"4311",4262,1,1,2,0.5,0.5
"4312",4263,1,1,2,0.5,0.5
"4313",4264,1,1,2,0.5,0.5
"4314",4265,1,1,2,0.5,0.5
"4315",4266,1,1,2,0.5,0.5
"4316",4267,1,1,2,0.5,0.5
"4317",4268,1,1,2,0.5,0.5
"4318",4269,1,1,2,0.5,0.5
"4319",4270,1,1,2,0.5,0.5
"4320",4271,1,1,2,0.5,0.5
"4321",4272,1,1,2,0.5,0.5
"4322",4273,1,1,2,0.5,0.5
"4323",4274,1,1,2,0.5,0.5
"4324",4275,1,1,2,0.5,0.5
"4325",4276,1,1,2,0.5,0.5
"4326",4277,1,1,2,0.5,0.5
"4327",4278,1,1,2,0.5,0.5
"4328",4279,1,1,2,0.5,0.5
"4329",4280,1,1,2,0.5,0.5
"4330",4281,1,1,2,0.5,0.5
"4331",4282,1,1,2,0.5,0.5
"4332",4283,1,1,2,0.5,0.5
"4333",4284,1,1,2,0.5,0.5
"4334",4285,1,1,2,0.5,0.5
"4335",4286,1,1,2,0.5,0.5
"4336",4287,1,1,2,0.5,0.5
"4337",4288,1,1,2,0.5,0.5
"4338",4289,1,1,2,0.5,0.5
"4339",4290,1,1,2,0.5,0.5
"4340",4291,1,1,2,0.5,0.5
"4341",4292,1,1,2,0.5,0.5
"4342",4293,1,1,2,0.5,0.5
"4343",4294,1,1,2,0.5,0.5
"4344",4295,1,1,2,0.5,0.5
"4345",4296,1,1,2,0.5,0.5
"4346",4297,1,1,2,0.5,0.5
"4347",4298,1,1,2,0.5,0.5
"4348",4299,1,1,2,0.5,0.5
"4349",4300,1,1,2,0.5,0.5
"4350",4301,1,1,2,0.5,0.5
"4351",4302,1,1,2,0.5,0.5
"4352",4303,1,1,2,0.5,0.5
"4353",4304,1,1,2,0.5,0.5
"4354",4305,1,1,2,0.5,0.5
"4355",4306,1,1,2,0.5,0.5
"4356",4307,1,1,2,0.5,0.5
"4357",4308,1,1,2,0.5,0.5
"4358",4309,1,1,2,0.5,0.5
"4359",4310,1,1,2,0.5,0.5
"4360",4311,1,1,2,0.5,0.5
"4361",4312,1,1,2,0.5,0.5
"4362",4313,1,1,2,0.5,0.5
"4363",4314,1,1,2,0.5,0.5
"4364",4315,1,1,2,0.5,0.5
"4365",4316,1,1,2,0.5,0.5
"4366",4317,1,1,2,0.5,0.5
"4367",4318,1,1,2,0.5,0.5
"4368",4319,1,1,2,0.5,0.5
"4369",4320,1,1,2,0.5,0.5
"4370",4321,1,1,2,0.5,0.5
"4371",4322,1,1,2,0.5,0.5
"4372",4323,1,1,2,0.5,0.5
"4373",4324,1,1,2,0.5,0.5
"4374",4325,1,1,2,0.5,0.5
"4375",4326,1,1,2,0.5,0.5
"4376",4327,1,1,2,0.5,0.5
"4377",4328,1,1,2,0.5,0.5
"4378",4329,1,1,2,0.5,0.5
"4379",4330,1,1,2,0.5,0.5
"4380",4331,1,1,2,0.5,0.5
"4381",4332,1,1,2,0.5,0.5
"4382",4333,1,1,2,0.5,0.5
"4383",4334,1,1,2,0.5,0.5
"4384",4335,1,1,2,0.5,0.5
"4385",4336,1,1,2,0.5,0.5
"4386",4337,1,1,2,0.5,0.5
"4387",4338,1,1,2,0.5,0.5
"4388",4339,1,1,2,0.5,0.5
"4389",4340,1,1,2,0.5,0.5
"4390",4341,1,1,2,0.5,0.5
"4391",4342,1,1,2,0.5,0.5
"4392",4343,1,1,2,0.5,0.5
"4393",4344,1,1,2,0.5,0.5
"4394",4345,1,1,2,0.5,0.5
"4395",4346,1,1,2,0.5,0.5
"4396",4347,1,1,2,0.5,0.5
"4397",4348,1,1,2,0.5,0.5
"4398",4349,1,1,2,0.5,0.5
"4399",4350,1,1,2,0.5,0.5
"4400",4351,1,1,2,0.5,0.5
"4401",4352,1,1,2,0.5,0.5
"4402",4353,1,1,2,0.5,0.5
"4403",4354,1,1,2,0.5,0.5
"4404",4355,1,1,2,0.5,0.5
"4405",4356,1,1,2,0.5,0.5
"4406",4357,1,1,2,0.5,0.5
"4407",4358,1,1,2,0.5,0.5
"4408",4359,1,1,2,0.5,0.5
"4409",4360,1,1,2,0.5,0.5
"4410",4361,1,1,2,0.5,0.5
"4411",4362,1,1,2,0.5,0.5
"4412",4363,1,1,2,0.5,0.5
"4413",4364,1,1,2,0.5,0.5
"4414",4365,1,1,2,0.5,0.5
"4415",4366,1,1,2,0.5,0.5
"4416",4367,1,1,2,0.5,0.5
"4417",4368,1,1,2,0.5,0.5
"4418",4369,1,1,2,0.5,0.5
"4419",4370,1,1,2,0.5,0.5
"4420",4371,1,1,2,0.5,0.5
"4421",4372,1,1,2,0.5,0.5
"4422",4373,1,1,2,0.5,0.5
"4423",4374,1,1,2,0.5,0.5
"4424",4375,1,1,2,0.5,0.5
"4425",4376,1,1,2,0.5,0.5
"4426",4377,1,1,2,0.5,0.5
"4427",4378,1,1,2,0.5,0.5
"4428",4379,1,1,2,0.5,0.5
"4429",4380,1,1,2,0.5,0.5
"4430",4381,1,1,2,0.5,0.5
"4431",4382,1,1,2,0.5,0.5
"4432",4383,1,1,2,0.5,0.5
"4433",4384,1,1,2,0.5,0.5
"4434",4385,1,1,2,0.5,0.5
"4435",4386,1,1,2,0.5,0.5
"4436",4387,1,1,2,0.5,0.5
"4437",4388,1,1,2,0.5,0.5
"4438",4389,1,1,2,0.5,0.5
"4439",4390,1,1,2,0.5,0.5
"4440",4391,1,1,2,0.5,0.5
"4441",4392,1,1,2,0.5,0.5
"4442",4393,1,1,2,0.5,0.5
"4443",4394,1,1,2,0.5,0.5
"4444",4395,1,1,2,0.5,0.5
"4445",4396,1,1,2,0.5,0.5
"4446",4397,1,1,2,0.5,0.5
"4447",4398,1,1,2,0.5,0.5
"4448",4399,1,1,2,0.5,0.5
"4449",4400,1,1,2,0.5,0.5
"4450",4401,1,1,2,0.5,0.5
"4451",4402,1,1,2,0.5,0.5
"4452",4403,1,1,2,0.5,0.5
"4453",4404,1,1,2,0.5,0.5
"4454",4405,1,1,2,0.5,0.5
"4455",4406,1,1,2,0.5,0.5
"4456",4407,1,1,2,0.5,0.5
"4457",4408,1,1,2,0.5,0.5
"4458",4409,1,1,2,0.5,0.5
"4459",4410,1,1,2,0.5,0.5
"4460",4411,1,1,2,0.5,0.5
"4461",4412,1,1,2,0.5,0.5
"4462",4413,1,1,2,0.5,0.5
"4463",4414,1,1,2,0.5,0.5
"4464",4415,1,1,2,0.5,0.5
"4465",4416,1,1,2,0.5,0.5
"4466",4417,1,1,2,0.5,0.5
"4467",4418,1,1,2,0.5,0.5
"4468",4419,1,1,2,0.5,0.5
"4469",4420,1,1,2,0.5,0.5
"4470",4421,1,1,2,0.5,0.5
"4471",4422,1,1,2,0.5,0.5
"4472",4423,1,1,2,0.5,0.5
"4473",4424,1,1,2,0.5,0.5
"4474",4425,1,1,2,0.5,0.5
"4475",4426,1,1,2,0.5,0.5
"4476",4427,1,1,2,0.5,0.5
"4477",4428,1,1,2,0.5,0.5
"4478",4429,1,1,2,0.5,0.5
"4479",4430,1,1,2,0.5,0.5
"4480",4431,1,1,2,0.5,0.5
"4481",4432,1,1,2,0.5,0.5
"4482",4433,1,1,2,0.5,0.5
"4483",4434,1,1,2,0.5,0.5
"4484",4435,1,1,2,0.5,0.5
"4485",4436,1,1,2,0.5,0.5
"4486",4437,1,1,2,0.5,0.5
"4487",4438,1,1,2,0.5,0.5
"4488",4439,1,1,2,0.5,0.5
"4489",4440,1,1,2,0.5,0.5
"4490",4441,1,1,2,0.5,0.5
"4491",4442,1,1,2,0.5,0.5
"4492",4443,1,1,2,0.5,0.5
"4493",4444,1,1,2,0.5,0.5
"4494",4445,1,1,2,0.5,0.5
"4495",4446,1,1,2,0.5,0.5
"4496",4447,1,1,2,0.5,0.5
"4497",4448,1,1,2,0.5,0.5
"4498",4449,1,1,2,0.5,0.5
"4499",4450,1,1,2,0.5,0.5
"4500",4451,1,1,2,0.5,0.5
"4501",4452,1,1,2,0.5,0.5
"4502",4453,1,1,2,0.5,0.5
"4503",4454,1,1,2,0.5,0.5
"4504",4455,1,1,2,0.5,0.5
"4505",4456,1,1,2,0.5,0.5
"4506",4457,1,1,2,0.5,0.5
"4507",4458,1,1,2,0.5,0.5
"4508",4459,1,1,2,0.5,0.5
"4509",4460,1,1,2,0.5,0.5
"4510",4461,1,1,2,0.5,0.5
"4511",4462,1,1,2,0.5,0.5
"4512",4463,1,1,2,0.5,0.5
"4513",4464,1,1,2,0.5,0.5
"4514",4465,1,1,2,0.5,0.5
"4515",4466,1,1,2,0.5,0.5
"4516",4467,1,1,2,0.5,0.5
"4517",4468,1,1,2,0.5,0.5
"4518",4469,1,1,2,0.5,0.5
"4519",4470,1,1,2,0.5,0.5
"4520",4471,1,1,2,0.5,0.5
"4521",4472,1,1,2,0.5,0.5
"4522",4473,1,1,2,0.5,0.5
"4523",4474,1,1,2,0.5,0.5
"4524",4475,1,1,2,0.5,0.5
"4525",4476,1,1,2,0.5,0.5
"4526",4477,1,1,2,0.5,0.5
"4527",4478,1,1,2,0.5,0.5
"4528",4479,1,1,2,0.5,0.5
"4529",4480,1,1,2,0.5,0.5
"4530",4481,1,1,2,0.5,0.5
"4531",4482,1,1,2,0.5,0.5
"4532",4483,1,1,2,0.5,0.5
"4533",4484,1,1,2,0.5,0.5
"4534",4485,1,1,2,0.5,0.5
"4535",4486,1,1,2,0.5,0.5
"4536",4487,1,1,2,0.5,0.5
"4537",4488,1,1,2,0.5,0.5
"4538",4489,1,1,2,0.5,0.5
"4539",4490,1,1,2,0.5,0.5
"4540",4491,1,1,2,0.5,0.5
"4541",4492,1,1,2,0.5,0.5
"4542",4493,1,1,2,0.5,0.5
"4543",4494,1,1,2,0.5,0.5
"4544",4495,1,1,2,0.5,0.5
"4545",4496,1,1,2,0.5,0.5
"4546",4497,1,1,2,0.5,0.5
"4547",4498,1,1,2,0.5,0.5
"4548",4499,1,1,2,0.5,0.5
"4549",4500,1,1,2,0.5,0.5
"4550",4501,1,1,2,0.5,0.5
"4551",4502,1,1,2,0.5,0.5
"4552",4503,1,1,2,0.5,0.5
"4553",4504,1,1,2,0.5,0.5
"4554",4505,1,1,2,0.5,0.5
"4555",4506,1,1,2,0.5,0.5
"4556",4507,1,1,2,0.5,0.5
"4557",4508,1,1,2,0.5,0.5
"4558",4509,1,1,2,0.5,0.5
"4559",4510,1,1,2,0.5,0.5
"4560",4511,1,1,2,0.5,0.5
"4561",4512,1,1,2,0.5,0.5
"4562",4513,1,1,2,0.5,0.5
"4563",4514,1,1,2,0.5,0.5
"4564",4515,1,1,2,0.5,0.5
"4565",4516,1,1,2,0.5,0.5
"4566",4517,1,1,2,0.5,0.5
"4567",4518,1,1,2,0.5,0.5
"4568",4519,1,1,2,0.5,0.5
"4569",4520,1,1,2,0.5,0.5
"4570",4521,1,1,2,0.5,0.5
"4571",4522,1,1,2,0.5,0.5
"4572",4523,1,1,2,0.5,0.5
"4573",4524,1,1,2,0.5,0.5
"4574",4525,1,1,2,0.5,0.5
"4575",4526,1,1,2,0.5,0.5
"4576",4527,1,1,2,0.5,0.5
"4577",4528,1,1,2,0.5,0.5
"4578",4529,1,1,2,0.5,0.5
"4579",4530,1,1,2,0.5,0.5
"4580",4531,1,1,2,0.5,0.5
"4581",4532,1,1,2,0.5,0.5
"4582",4533,1,1,2,0.5,0.5
"4583",4534,1,1,2,0.5,0.5
"4584",4535,1,1,2,0.5,0.5
"4585",4536,1,1,2,0.5,0.5
"4586",4537,1,1,2,0.5,0.5
"4587",4538,1,1,2,0.5,0.5
"4588",4539,1,1,2,0.5,0.5
"4589",4540,1,1,2,0.5,0.5
"4590",4542,1,1,2,0.5,0.5
"4591",4543,1,1,2,0.5,0.5
"4592",4544,0,2,2,0,1
"4593",4546,1,1,2,0.5,0.5
"4594",4547,1,1,2,0.5,0.5
"4595",4548,1,1,2,0.5,0.5
"4596",4549,1,1,2,0.5,0.5
"4597",4550,1,1,2,0.5,0.5
"4598",4551,0,2,2,0,1
"4599",4553,1,1,2,0.5,0.5
"4600",4554,0,2,2,0,1
"4601",4555,1,1,2,0.5,0.5
"4602",4556,0,2,2,0,1
"4603",4557,0,2,2,0,1
"4604",4558,1,1,2,0.5,0.5
"4605",4559,0,2,2,0,1
"4606",4560,1,1,2,0.5,0.5
"4607",4562,0,2,2,0,1
"4608",4563,0,2,2,0,1
"4609",4564,0,2,2,0,1
"4610",4565,1,1,2,0.5,0.5
"4611",4566,0,2,2,0,1
"4612",4567,1,1,2,0.5,0.5
"4613",4568,0,2,2,0,1
"4614",4569,1,1,2,0.5,0.5
"4615",4570,0,2,2,0,1
"4616",4571,1,1,2,0.5,0.5
"4617",4572,0,2,2,0,1
"4618",4573,1,1,2,0.5,0.5
"4619",4574,1,1,2,0.5,0.5
"4620",4575,1,1,2,0.5,0.5
"4621",4576,1,1,2,0.5,0.5
"4622",4577,1,1,2,0.5,0.5
"4623",4579,1,1,2,0.5,0.5
"4624",4580,1,1,2,0.5,0.5
"4625",4581,1,1,2,0.5,0.5
"4626",4582,1,1,2,0.5,0.5
"4627",4583,1,1,2,0.5,0.5
"4628",4584,1,1,2,0.5,0.5
"4629",4585,1,1,2,0.5,0.5
"4630",4586,1,1,2,0.5,0.5
"4631",4587,1,1,2,0.5,0.5
"4632",4588,1,1,2,0.5,0.5
"4633",4589,1,1,2,0.5,0.5
"4634",4591,1,1,2,0.5,0.5
"4635",4592,1,1,2,0.5,0.5
"4636",4593,1,1,2,0.5,0.5
"4637",4594,1,1,2,0.5,0.5
"4638",4595,1,1,2,0.5,0.5
"4639",4596,1,1,2,0.5,0.5
"4640",4597,1,1,2,0.5,0.5
"4641",4598,1,1,2,0.5,0.5
"4642",4599,1,1,2,0.5,0.5
"4643",4600,1,1,2,0.5,0.5
"4644",4601,1,1,2,0.5,0.5
"4645",4602,1,1,2,0.5,0.5
"4646",4603,1,1,2,0.5,0.5
"4647",4604,1,1,2,0.5,0.5
"4648",4605,1,1,2,0.5,0.5
"4649",4606,1,1,2,0.5,0.5
"4650",4607,1,1,2,0.5,0.5
"4651",4608,1,1,2,0.5,0.5
"4652",4609,1,1,2,0.5,0.5
"4653",4610,1,1,2,0.5,0.5
"4654",4611,1,1,2,0.5,0.5
"4655",4612,1,1,2,0.5,0.5
"4656",4613,1,1,2,0.5,0.5
"4657",4614,1,1,2,0.5,0.5
"4658",4615,1,1,2,0.5,0.5
"4659",4616,1,1,2,0.5,0.5
"4660",4617,1,1,2,0.5,0.5
"4661",4618,1,1,2,0.5,0.5
"4662",4619,1,1,2,0.5,0.5
"4663",4620,1,1,2,0.5,0.5
"4664",4621,1,1,2,0.5,0.5
"4665",4622,1,1,2,0.5,0.5
"4666",4623,1,1,2,0.5,0.5
"4667",4624,1,1,2,0.5,0.5
"4668",4625,1,1,2,0.5,0.5
"4669",4626,1,1,2,0.5,0.5
"4670",4627,1,1,2,0.5,0.5
"4671",4628,1,1,2,0.5,0.5
"4672",4629,1,1,2,0.5,0.5
"4673",4630,1,1,2,0.5,0.5
"4674",4631,1,1,2,0.5,0.5
"4675",4632,1,1,2,0.5,0.5
"4676",4633,1,1,2,0.5,0.5
"4677",4634,1,1,2,0.5,0.5
"4678",4635,1,1,2,0.5,0.5
"4679",4636,1,1,2,0.5,0.5
"4680",4637,1,1,2,0.5,0.5
"4681",4638,1,1,2,0.5,0.5
"4682",4639,1,1,2,0.5,0.5
"4683",4640,1,1,2,0.5,0.5
"4684",4641,1,1,2,0.5,0.5
"4685",4642,1,1,2,0.5,0.5
"4686",4643,1,1,2,0.5,0.5
"4687",4644,1,1,2,0.5,0.5
"4688",4645,1,1,2,0.5,0.5
"4689",4646,1,1,2,0.5,0.5
"4690",4647,1,1,2,0.5,0.5
"4691",4648,1,1,2,0.5,0.5
"4692",4649,1,1,2,0.5,0.5
"4693",4650,1,1,2,0.5,0.5
"4694",4652,1,1,2,0.5,0.5
"4695",4653,1,1,2,0.5,0.5
"4696",4654,1,1,2,0.5,0.5
"4697",4655,1,1,2,0.5,0.5
"4698",4656,1,1,2,0.5,0.5
"4699",4657,1,1,2,0.5,0.5
"4700",4658,1,1,2,0.5,0.5
"4701",4659,1,1,2,0.5,0.5
"4702",4660,1,1,2,0.5,0.5
"4703",4661,1,1,2,0.5,0.5
"4704",4662,1,1,2,0.5,0.5
"4705",4663,1,1,2,0.5,0.5
"4706",4664,1,1,2,0.5,0.5
"4707",4665,1,1,2,0.5,0.5
"4708",4666,1,1,2,0.5,0.5
"4709",4667,1,1,2,0.5,0.5
"4710",4668,1,1,2,0.5,0.5
"4711",4669,1,1,2,0.5,0.5
"4712",4670,1,1,2,0.5,0.5
"4713",4671,1,1,2,0.5,0.5
"4714",4672,1,1,2,0.5,0.5
"4715",4673,1,1,2,0.5,0.5
"4716",4674,1,1,2,0.5,0.5
"4717",4675,1,1,2,0.5,0.5
"4718",4676,1,1,2,0.5,0.5
"4719",4677,1,1,2,0.5,0.5
"4720",4678,1,1,2,0.5,0.5
"4721",4679,1,1,2,0.5,0.5
"4722",4680,1,1,2,0.5,0.5
"4723",4681,1,1,2,0.5,0.5
"4724",4682,1,1,2,0.5,0.5
"4725",4683,1,1,2,0.5,0.5
"4726",4684,1,1,2,0.5,0.5
"4727",4685,1,1,2,0.5,0.5
"4728",4686,1,1,2,0.5,0.5
"4729",4687,1,1,2,0.5,0.5
"4730",4688,1,1,2,0.5,0.5
"4731",4689,1,1,2,0.5,0.5
"4732",4690,1,1,2,0.5,0.5
"4733",4691,1,1,2,0.5,0.5
"4734",4692,1,1,2,0.5,0.5
"4735",4693,1,1,2,0.5,0.5
"4736",4694,1,1,2,0.5,0.5
"4737",4695,1,1,2,0.5,0.5
"4738",4696,1,1,2,0.5,0.5
"4739",4697,1,1,2,0.5,0.5
"4740",4698,1,1,2,0.5,0.5
"4741",4699,1,1,2,0.5,0.5
"4742",4700,1,1,2,0.5,0.5
"4743",4701,1,1,2,0.5,0.5
"4744",4702,1,1,2,0.5,0.5
"4745",4703,1,1,2,0.5,0.5
"4746",4704,1,1,2,0.5,0.5
"4747",4705,1,1,2,0.5,0.5
"4748",4706,1,1,2,0.5,0.5
"4749",4707,1,1,2,0.5,0.5
"4750",4708,1,1,2,0.5,0.5
"4751",4709,1,1,2,0.5,0.5
"4752",4710,1,1,2,0.5,0.5
"4753",4711,1,1,2,0.5,0.5
"4754",4712,1,1,2,0.5,0.5
"4755",4713,1,1,2,0.5,0.5
"4756",4714,1,1,2,0.5,0.5
"4757",4715,1,1,2,0.5,0.5
"4758",4716,1,1,2,0.5,0.5
"4759",4717,1,1,2,0.5,0.5
"4760",4718,1,1,2,0.5,0.5
"4761",4719,1,1,2,0.5,0.5
"4762",4720,1,1,2,0.5,0.5
"4763",4721,1,1,2,0.5,0.5
"4764",4722,1,1,2,0.5,0.5
"4765",4723,1,1,2,0.5,0.5
"4766",4724,1,1,2,0.5,0.5
"4767",4725,1,1,2,0.5,0.5
"4768",4726,1,1,2,0.5,0.5
"4769",4727,1,1,2,0.5,0.5
"4770",4728,1,1,2,0.5,0.5
"4771",4729,1,1,2,0.5,0.5
"4772",4730,1,1,2,0.5,0.5
"4773",4731,1,1,2,0.5,0.5
"4774",4732,1,1,2,0.5,0.5
"4775",4733,1,1,2,0.5,0.5
"4776",4734,1,1,2,0.5,0.5
"4777",4735,1,1,2,0.5,0.5
"4778",4736,1,1,2,0.5,0.5
"4779",4737,1,1,2,0.5,0.5
"4780",4738,1,1,2,0.5,0.5
"4781",4739,1,1,2,0.5,0.5
"4782",4740,1,1,2,0.5,0.5
"4783",4741,1,1,2,0.5,0.5
"4784",4742,1,1,2,0.5,0.5
"4785",4743,1,1,2,0.5,0.5
"4786",4744,1,1,2,0.5,0.5
"4787",4745,1,1,2,0.5,0.5
"4788",4746,1,1,2,0.5,0.5
"4789",4747,1,1,2,0.5,0.5
"4790",4748,1,1,2,0.5,0.5
"4791",4749,1,1,2,0.5,0.5
"4792",4750,1,1,2,0.5,0.5
"4793",4751,1,1,2,0.5,0.5
"4794",4752,1,1,2,0.5,0.5
"4795",4753,1,1,2,0.5,0.5
"4796",4754,1,1,2,0.5,0.5
"4797",4755,1,1,2,0.5,0.5
"4798",4756,1,1,2,0.5,0.5
"4799",4758,1,1,2,0.5,0.5
"4800",4759,1,1,2,0.5,0.5
"4801",4760,1,1,2,0.5,0.5
"4802",4761,1,1,2,0.5,0.5
"4803",4762,1,1,2,0.5,0.5
"4804",4763,1,1,2,0.5,0.5
"4805",4764,1,1,2,0.5,0.5
"4806",4765,1,1,2,0.5,0.5
"4807",4766,1,1,2,0.5,0.5
"4808",4767,1,1,2,0.5,0.5
"4809",4768,1,1,2,0.5,0.5
"4810",4769,1,1,2,0.5,0.5
"4811",4770,1,1,2,0.5,0.5
"4812",4771,1,1,2,0.5,0.5
"4813",4772,1,1,2,0.5,0.5
"4814",4773,1,1,2,0.5,0.5
"4815",4774,1,1,2,0.5,0.5
"4816",4775,1,1,2,0.5,0.5
"4817",4776,1,1,2,0.5,0.5
"4818",4777,1,1,2,0.5,0.5
"4819",4778,1,1,2,0.5,0.5
"4820",4779,1,1,2,0.5,0.5
"4821",4780,1,1,2,0.5,0.5
"4822",4781,1,1,2,0.5,0.5
"4823",4782,1,1,2,0.5,0.5
"4824",4783,1,1,2,0.5,0.5
"4825",4784,1,1,2,0.5,0.5
"4826",4785,1,1,2,0.5,0.5
"4827",4786,1,1,2,0.5,0.5
"4828",4787,1,1,2,0.5,0.5
"4829",4788,1,1,2,0.5,0.5
"4830",4789,1,1,2,0.5,0.5
"4831",4790,1,1,2,0.5,0.5
"4832",4791,1,1,2,0.5,0.5
"4833",4792,1,1,2,0.5,0.5
"4834",4793,1,1,2,0.5,0.5
"4835",4794,1,1,2,0.5,0.5
"4836",4795,1,1,2,0.5,0.5
"4837",4796,1,1,2,0.5,0.5
"4838",4797,1,1,2,0.5,0.5
"4839",4798,1,1,2,0.5,0.5
"4840",4799,1,1,2,0.5,0.5
"4841",4800,1,1,2,0.5,0.5
"4842",4801,1,1,2,0.5,0.5
"4843",4802,1,1,2,0.5,0.5
"4844",4803,1,1,2,0.5,0.5
"4845",4804,1,1,2,0.5,0.5
"4846",4805,1,1,2,0.5,0.5
"4847",4806,1,1,2,0.5,0.5
"4848",4807,1,1,2,0.5,0.5
"4849",4808,1,1,2,0.5,0.5
"4850",4809,1,1,2,0.5,0.5
"4851",4810,1,1,2,0.5,0.5
"4852",4811,1,1,2,0.5,0.5
"4853",4812,1,1,2,0.5,0.5
"4854",4813,1,1,2,0.5,0.5
"4855",4814,1,1,2,0.5,0.5
"4856",4815,1,1,2,0.5,0.5
"4857",4816,1,1,2,0.5,0.5
"4858",4817,1,1,2,0.5,0.5
"4859",4818,1,1,2,0.5,0.5
"4860",4819,1,1,2,0.5,0.5
"4861",4820,1,1,2,0.5,0.5
"4862",4821,1,1,2,0.5,0.5
"4863",4822,1,1,2,0.5,0.5
"4864",4823,1,1,2,0.5,0.5
"4865",4824,1,1,2,0.5,0.5
"4866",4825,1,1,2,0.5,0.5
"4867",4826,1,1,2,0.5,0.5
"4868",4827,1,1,2,0.5,0.5
"4869",4828,1,1,2,0.5,0.5
"4870",4829,1,1,2,0.5,0.5
"4871",4830,1,1,2,0.5,0.5
"4872",4831,1,1,2,0.5,0.5
"4873",4832,1,1,2,0.5,0.5
"4874",4833,1,1,2,0.5,0.5
"4875",4834,1,1,2,0.5,0.5
"4876",4835,1,1,2,0.5,0.5
"4877",4836,1,1,2,0.5,0.5
"4878",4837,1,1,2,0.5,0.5
"4879",4838,1,1,2,0.5,0.5
"4880",4839,1,1,2,0.5,0.5
"4881",4840,1,1,2,0.5,0.5
"4882",4841,1,1,2,0.5,0.5
"4883",4842,1,1,2,0.5,0.5
"4884",4843,1,1,2,0.5,0.5
"4885",4844,1,1,2,0.5,0.5
"4886",4845,1,1,2,0.5,0.5
"4887",4846,1,1,2,0.5,0.5
"4888",4847,1,1,2,0.5,0.5
"4889",4848,1,1,2,0.5,0.5
"4890",4849,1,1,2,0.5,0.5
"4891",4850,1,1,2,0.5,0.5
"4892",4851,1,1,2,0.5,0.5
"4893",4852,1,1,2,0.5,0.5
"4894",4853,1,1,2,0.5,0.5
"4895",4854,1,1,2,0.5,0.5
"4896",4855,1,1,2,0.5,0.5
"4897",4856,1,1,2,0.5,0.5
"4898",4857,1,1,2,0.5,0.5
"4899",4858,1,1,2,0.5,0.5
"4900",4859,1,1,2,0.5,0.5
"4901",4860,1,1,2,0.5,0.5
"4902",4861,1,1,2,0.5,0.5
"4903",4862,1,1,2,0.5,0.5
"4904",4863,1,1,2,0.5,0.5
"4905",4864,1,1,2,0.5,0.5
"4906",4865,1,1,2,0.5,0.5
"4907",4866,1,1,2,0.5,0.5
"4908",4867,1,1,2,0.5,0.5
"4909",4868,1,1,2,0.5,0.5
"4910",4869,1,1,2,0.5,0.5
"4911",4870,1,1,2,0.5,0.5
"4912",4871,1,1,2,0.5,0.5
"4913",4872,1,1,2,0.5,0.5
"4914",4873,1,1,2,0.5,0.5
"4915",4874,1,1,2,0.5,0.5
"4916",4875,1,1,2,0.5,0.5
"4917",4876,1,1,2,0.5,0.5
"4918",4877,1,1,2,0.5,0.5
"4919",4878,1,1,2,0.5,0.5
"4920",4879,1,1,2,0.5,0.5
"4921",4880,1,1,2,0.5,0.5
"4922",4881,1,1,2,0.5,0.5
"4923",4882,1,1,2,0.5,0.5
"4924",4883,1,1,2,0.5,0.5
"4925",4884,1,1,2,0.5,0.5
"4926",4885,1,1,2,0.5,0.5
"4927",4886,1,1,2,0.5,0.5
"4928",4887,1,1,2,0.5,0.5
"4929",4888,1,1,2,0.5,0.5
"4930",4889,1,1,2,0.5,0.5
"4931",4890,1,1,2,0.5,0.5
"4932",4891,1,1,2,0.5,0.5
"4933",4892,1,1,2,0.5,0.5
"4934",4893,1,1,2,0.5,0.5
"4935",4894,1,1,2,0.5,0.5
"4936",4895,1,1,2,0.5,0.5
"4937",4896,1,1,2,0.5,0.5
"4938",4897,1,1,2,0.5,0.5
"4939",4898,1,1,2,0.5,0.5
"4940",4899,1,1,2,0.5,0.5
"4941",4900,1,1,2,0.5,0.5
"4942",4901,1,1,2,0.5,0.5
"4943",4902,1,1,2,0.5,0.5
"4944",4903,1,1,2,0.5,0.5
"4945",4904,1,1,2,0.5,0.5
"4946",4905,1,1,2,0.5,0.5
"4947",4906,1,1,2,0.5,0.5
"4948",4907,1,1,2,0.5,0.5
"4949",4908,1,1,2,0.5,0.5
"4950",4909,1,1,2,0.5,0.5
"4951",4910,1,1,2,0.5,0.5
"4952",4911,1,1,2,0.5,0.5
"4953",4912,1,1,2,0.5,0.5
"4954",4913,1,1,2,0.5,0.5
"4955",4914,1,1,2,0.5,0.5
"4956",4915,1,1,2,0.5,0.5
"4957",4916,1,1,2,0.5,0.5
"4958",4917,1,1,2,0.5,0.5
"4959",4918,1,1,2,0.5,0.5
"4960",4919,1,1,2,0.5,0.5
"4961",4920,1,1,2,0.5,0.5
"4962",4921,1,1,2,0.5,0.5
"4963",4922,1,1,2,0.5,0.5
"4964",4923,1,1,2,0.5,0.5
"4965",4924,1,1,2,0.5,0.5
"4966",4925,1,1,2,0.5,0.5
"4967",4926,1,1,2,0.5,0.5
"4968",4927,1,1,2,0.5,0.5
"4969",4928,1,1,2,0.5,0.5
"4970",4929,1,1,2,0.5,0.5
"4971",4930,1,1,2,0.5,0.5
"4972",4932,1,1,2,0.5,0.5
"4973",4933,1,1,2,0.5,0.5
"4974",4934,1,1,2,0.5,0.5
"4975",4935,1,1,2,0.5,0.5
"4976",4936,1,1,2,0.5,0.5
"4977",4937,1,1,2,0.5,0.5
"4978",4938,1,1,2,0.5,0.5
"4979",4939,1,1,2,0.5,0.5
"4980",4940,1,1,2,0.5,0.5
"4981",4941,1,1,2,0.5,0.5
"4982",4942,1,1,2,0.5,0.5
"4983",4943,1,1,2,0.5,0.5
"4984",4944,1,1,2,0.5,0.5
"4985",4945,1,1,2,0.5,0.5
"4986",4946,1,1,2,0.5,0.5
"4987",4947,1,1,2,0.5,0.5
"4988",4948,1,1,2,0.5,0.5
"4989",4949,1,1,2,0.5,0.5
"4990",4950,1,1,2,0.5,0.5
"4991",4951,1,1,2,0.5,0.5
"4992",4952,1,1,2,0.5,0.5
"4993",4953,1,1,2,0.5,0.5
"4994",4954,1,1,2,0.5,0.5
"4995",4955,1,1,2,0.5,0.5
"4996",4956,1,1,2,0.5,0.5
"4997",4957,1,1,2,0.5,0.5
"4998",4958,1,1,2,0.5,0.5
"4999",4959,1,1,2,0.5,0.5
"5000",4960,1,1,2,0.5,0.5
"5001",4961,1,1,2,0.5,0.5
"5002",4962,1,1,2,0.5,0.5
"5003",4963,1,1,2,0.5,0.5
"5004",4964,1,1,2,0.5,0.5
"5005",4965,1,1,2,0.5,0.5
"5006",4966,1,1,2,0.5,0.5
"5007",4967,1,1,2,0.5,0.5
"5008",4968,1,1,2,0.5,0.5
"5009",4969,1,1,2,0.5,0.5
"5010",4970,1,1,2,0.5,0.5
"5011",4971,1,1,2,0.5,0.5
"5012",4972,1,1,2,0.5,0.5
"5013",4973,1,1,2,0.5,0.5
"5014",4974,1,1,2,0.5,0.5
"5015",4975,1,1,2,0.5,0.5
"5016",4976,1,1,2,0.5,0.5
"5017",4977,1,1,2,0.5,0.5
"5018",4978,1,1,2,0.5,0.5
"5019",4979,1,1,2,0.5,0.5
"5020",4980,1,1,2,0.5,0.5
"5021",4981,1,1,2,0.5,0.5
"5022",4982,1,1,2,0.5,0.5
"5023",4983,1,1,2,0.5,0.5
"5024",4984,1,1,2,0.5,0.5
"5025",4985,1,1,2,0.5,0.5
"5026",4986,1,1,2,0.5,0.5
"5027",4987,1,1,2,0.5,0.5
"5028",4988,1,1,2,0.5,0.5
"5029",4989,1,1,2,0.5,0.5
"5030",4990,1,1,2,0.5,0.5
"5031",4991,1,1,2,0.5,0.5
"5032",4992,1,1,2,0.5,0.5
"5033",4993,1,1,2,0.5,0.5
"5034",4994,1,1,2,0.5,0.5
"5035",4995,1,1,2,0.5,0.5
"5036",4996,1,1,2,0.5,0.5
"5037",4997,1,1,2,0.5,0.5
"5038",4998,1,1,2,0.5,0.5
"5039",4999,1,1,2,0.5,0.5
"5040",5000,1,1,2,0.5,0.5
"5041",5001,1,1,2,0.5,0.5
"5042",5002,1,1,2,0.5,0.5
"5043",5003,1,1,2,0.5,0.5
"5044",5004,1,1,2,0.5,0.5
"5045",5005,1,1,2,0.5,0.5
"5046",5006,1,1,2,0.5,0.5
"5047",5007,1,1,2,0.5,0.5
"5048",5008,1,1,2,0.5,0.5
"5049",5009,1,1,2,0.5,0.5
"5050",5010,1,1,2,0.5,0.5
"5051",5011,1,1,2,0.5,0.5
"5052",5012,1,1,2,0.5,0.5
"5053",5013,1,1,2,0.5,0.5
"5054",5014,1,1,2,0.5,0.5
"5055",5015,1,1,2,0.5,0.5
"5056",5016,1,1,2,0.5,0.5
"5057",5017,1,1,2,0.5,0.5
"5058",5018,1,1,2,0.5,0.5
"5059",5019,1,1,2,0.5,0.5
"5060",5020,1,1,2,0.5,0.5
"5061",5021,1,1,2,0.5,0.5
"5062",5022,1,1,2,0.5,0.5
"5063",5024,1,1,2,0.5,0.5
"5064",5025,1,1,2,0.5,0.5
"5065",5026,1,1,2,0.5,0.5
"5066",5027,1,1,2,0.5,0.5
"5067",5028,1,1,2,0.5,0.5
"5068",5029,1,1,2,0.5,0.5
"5069",5030,1,1,2,0.5,0.5
"5070",5031,1,1,2,0.5,0.5
"5071",5032,1,1,2,0.5,0.5
"5072",5033,1,1,2,0.5,0.5
"5073",5034,1,1,2,0.5,0.5
"5074",5035,1,1,2,0.5,0.5
"5075",5036,1,1,2,0.5,0.5
"5076",5037,1,1,2,0.5,0.5
"5077",5038,1,1,2,0.5,0.5
"5078",5039,1,1,2,0.5,0.5
"5079",5040,1,1,2,0.5,0.5
"5080",5041,1,1,2,0.5,0.5
"5081",5042,1,1,2,0.5,0.5
"5082",5043,1,1,2,0.5,0.5
"5083",5044,1,1,2,0.5,0.5
"5084",5045,1,1,2,0.5,0.5
"5085",5046,1,1,2,0.5,0.5
"5086",5047,1,1,2,0.5,0.5
"5087",5048,1,1,2,0.5,0.5
"5088",5049,1,1,2,0.5,0.5
"5089",5050,1,1,2,0.5,0.5
"5090",5051,1,1,2,0.5,0.5
"5091",5052,1,1,2,0.5,0.5
"5092",5053,1,1,2,0.5,0.5
"5093",5054,1,1,2,0.5,0.5
"5094",5055,1,1,2,0.5,0.5
"5095",5056,1,1,2,0.5,0.5
"5096",5057,1,1,2,0.5,0.5
"5097",5058,1,1,2,0.5,0.5
"5098",5059,1,1,2,0.5,0.5
"5099",5060,1,1,2,0.5,0.5
"5100",5061,1,1,2,0.5,0.5
"5101",5062,1,1,2,0.5,0.5
"5102",5063,1,1,2,0.5,0.5
"5103",5064,1,1,2,0.5,0.5
"5104",5065,1,1,2,0.5,0.5
"5105",5066,1,1,2,0.5,0.5
"5106",5067,1,1,2,0.5,0.5
"5107",5068,1,1,2,0.5,0.5
"5108",5069,1,1,2,0.5,0.5
"5109",5070,1,1,2,0.5,0.5
"5110",5071,1,1,2,0.5,0.5
"5111",5072,1,1,2,0.5,0.5
"5112",5073,1,1,2,0.5,0.5
"5113",5074,1,1,2,0.5,0.5
"5114",5075,1,1,2,0.5,0.5
"5115",5076,1,1,2,0.5,0.5
"5116",5077,1,1,2,0.5,0.5
"5117",5078,1,1,2,0.5,0.5
"5118",5079,1,1,2,0.5,0.5
"5119",5080,1,1,2,0.5,0.5
"5120",5081,1,1,2,0.5,0.5
"5121",5082,1,1,2,0.5,0.5
"5122",5083,1,1,2,0.5,0.5
"5123",5084,1,1,2,0.5,0.5
"5124",5085,1,1,2,0.5,0.5
"5125",5086,1,1,2,0.5,0.5
"5126",5087,1,1,2,0.5,0.5
"5127",5088,1,1,2,0.5,0.5
"5128",5089,1,1,2,0.5,0.5
"5129",5090,1,1,2,0.5,0.5
"5130",5091,1,1,2,0.5,0.5
"5131",5092,1,1,2,0.5,0.5
"5132",5093,1,1,2,0.5,0.5
"5133",5094,1,1,2,0.5,0.5
"5134",5095,1,1,2,0.5,0.5
"5135",5096,1,1,2,0.5,0.5
"5136",5097,1,1,2,0.5,0.5
"5137",5098,1,1,2,0.5,0.5
"5138",5099,1,1,2,0.5,0.5
"5139",5100,1,1,2,0.5,0.5
"5140",5101,1,1,2,0.5,0.5
"5141",5102,1,1,2,0.5,0.5
"5142",5103,1,1,2,0.5,0.5
"5143",5104,1,1,2,0.5,0.5
"5144",5105,1,1,2,0.5,0.5
"5145",5106,1,1,2,0.5,0.5
"5146",5107,1,1,2,0.5,0.5
"5147",5108,1,1,2,0.5,0.5
"5148",5109,1,1,2,0.5,0.5
"5149",5110,1,1,2,0.5,0.5
"5150",5111,1,1,2,0.5,0.5
"5151",5112,1,1,2,0.5,0.5
"5152",5113,1,1,2,0.5,0.5
"5153",5114,1,1,2,0.5,0.5
"5154",5115,1,1,2,0.5,0.5
"5155",5116,1,1,2,0.5,0.5
"5156",5117,1,1,2,0.5,0.5
"5157",5118,1,1,2,0.5,0.5
"5158",5119,1,1,2,0.5,0.5
"5159",5120,1,1,2,0.5,0.5
"5160",5121,1,1,2,0.5,0.5
"5161",5122,1,1,2,0.5,0.5
"5162",5123,1,1,2,0.5,0.5
"5163",5124,1,1,2,0.5,0.5
"5164",5125,1,1,2,0.5,0.5
"5165",5126,1,1,2,0.5,0.5
"5166",5127,1,1,2,0.5,0.5
"5167",5128,1,1,2,0.5,0.5
"5168",5129,1,1,2,0.5,0.5
"5169",5130,1,1,2,0.5,0.5
"5170",5131,1,1,2,0.5,0.5
"5171",5132,1,1,2,0.5,0.5
"5172",5133,1,1,2,0.5,0.5
"5173",5134,1,1,2,0.5,0.5
"5174",5135,1,1,2,0.5,0.5
"5175",5136,1,1,2,0.5,0.5
"5176",5137,1,1,2,0.5,0.5
"5177",5138,1,1,2,0.5,0.5
"5178",5139,1,1,2,0.5,0.5
"5179",5140,1,1,2,0.5,0.5
"5180",5141,1,1,2,0.5,0.5
"5181",5142,1,1,2,0.5,0.5
"5182",5143,1,1,2,0.5,0.5
"5183",5144,1,1,2,0.5,0.5
"5184",5145,1,1,2,0.5,0.5
"5185",5146,1,1,2,0.5,0.5
"5186",5147,1,1,2,0.5,0.5
"5187",5148,1,1,2,0.5,0.5
"5188",5149,1,1,2,0.5,0.5
"5189",5150,1,1,2,0.5,0.5
"5190",5151,1,1,2,0.5,0.5
"5191",5152,1,1,2,0.5,0.5
"5192",5153,1,1,2,0.5,0.5
"5193",5154,1,1,2,0.5,0.5
"5194",5155,1,1,2,0.5,0.5
"5195",5156,1,1,2,0.5,0.5
"5196",5157,1,1,2,0.5,0.5
"5197",5158,1,1,2,0.5,0.5
"5198",5159,1,1,2,0.5,0.5
"5199",5160,1,1,2,0.5,0.5
"5200",5161,1,1,2,0.5,0.5
"5201",5162,1,1,2,0.5,0.5
"5202",5163,1,1,2,0.5,0.5
"5203",5164,1,1,2,0.5,0.5
"5204",5165,1,1,2,0.5,0.5
"5205",5166,1,1,2,0.5,0.5
"5206",5167,1,1,2,0.5,0.5
"5207",5168,1,1,2,0.5,0.5
"5208",5169,1,1,2,0.5,0.5
"5209",5170,1,1,2,0.5,0.5
"5210",5171,1,1,2,0.5,0.5
"5211",5172,1,1,2,0.5,0.5
"5212",5173,1,1,2,0.5,0.5
"5213",5174,1,1,2,0.5,0.5
"5214",5175,1,1,2,0.5,0.5
"5215",5176,1,1,2,0.5,0.5
"5216",5177,1,1,2,0.5,0.5
"5217",5178,1,1,2,0.5,0.5
"5218",5179,1,1,2,0.5,0.5
"5219",5180,1,1,2,0.5,0.5
"5220",5181,1,1,2,0.5,0.5
"5221",5182,1,1,2,0.5,0.5
"5222",5183,1,1,2,0.5,0.5
"5223",5184,1,1,2,0.5,0.5
"5224",5185,1,1,2,0.5,0.5
"5225",5186,1,1,2,0.5,0.5
"5226",5187,1,1,2,0.5,0.5
"5227",5188,1,1,2,0.5,0.5
"5228",5189,1,1,2,0.5,0.5
"5229",5190,1,1,2,0.5,0.5
"5230",5191,1,1,2,0.5,0.5
"5231",5192,1,1,2,0.5,0.5
"5232",5193,1,1,2,0.5,0.5
"5233",5194,1,1,2,0.5,0.5
"5234",5195,1,1,2,0.5,0.5
"5235",5196,1,1,2,0.5,0.5
"5236",5197,1,1,2,0.5,0.5
"5237",5198,1,1,2,0.5,0.5
"5238",5199,1,1,2,0.5,0.5
"5239",5200,1,1,2,0.5,0.5
"5240",5201,1,1,2,0.5,0.5
"5241",5202,1,1,2,0.5,0.5
"5242",5203,1,1,2,0.5,0.5
"5243",5204,1,1,2,0.5,0.5
"5244",5205,1,1,2,0.5,0.5
"5245",5206,1,1,2,0.5,0.5
"5246",5207,1,1,2,0.5,0.5
"5247",5208,1,1,2,0.5,0.5
"5248",5209,1,1,2,0.5,0.5
"5249",5210,1,1,2,0.5,0.5
"5250",5211,1,1,2,0.5,0.5
"5251",5212,1,1,2,0.5,0.5
"5252",5213,1,1,2,0.5,0.5
"5253",5214,1,1,2,0.5,0.5
"5254",5215,1,1,2,0.5,0.5
"5255",5216,1,1,2,0.5,0.5
"5256",5217,1,1,2,0.5,0.5
"5257",5218,1,1,2,0.5,0.5
"5258",5219,1,1,2,0.5,0.5
"5259",5220,1,1,2,0.5,0.5
"5260",5221,1,1,2,0.5,0.5
"5261",5222,1,1,2,0.5,0.5
"5262",5223,1,1,2,0.5,0.5
"5263",5224,1,1,2,0.5,0.5
"5264",5225,1,1,2,0.5,0.5
"5265",5226,1,1,2,0.5,0.5
"5266",5227,1,1,2,0.5,0.5
"5267",5228,1,1,2,0.5,0.5
"5268",5229,1,1,2,0.5,0.5
"5269",5230,1,1,2,0.5,0.5
"5270",5231,1,1,2,0.5,0.5
"5271",5232,1,1,2,0.5,0.5
"5272",5233,1,1,2,0.5,0.5
"5273",5234,1,1,2,0.5,0.5
"5274",5235,1,1,2,0.5,0.5
"5275",5236,1,1,2,0.5,0.5
"5276",5237,1,1,2,0.5,0.5
"5277",5238,1,1,2,0.5,0.5
"5278",5239,1,1,2,0.5,0.5
"5279",5240,1,1,2,0.5,0.5
"5280",5241,1,1,2,0.5,0.5
"5281",5242,1,1,2,0.5,0.5
"5282",5243,1,1,2,0.5,0.5
"5283",5244,1,1,2,0.5,0.5
"5284",5245,1,1,2,0.5,0.5
"5285",5246,1,1,2,0.5,0.5
"5286",5247,1,1,2,0.5,0.5
"5287",5248,1,1,2,0.5,0.5
"5288",5249,1,1,2,0.5,0.5
"5289",5250,1,1,2,0.5,0.5
"5290",5251,1,1,2,0.5,0.5
"5291",5252,1,1,2,0.5,0.5
"5292",5253,1,1,2,0.5,0.5
"5293",5254,1,1,2,0.5,0.5
"5294",5255,1,1,2,0.5,0.5
"5295",5256,1,1,2,0.5,0.5
"5296",5257,1,1,2,0.5,0.5
"5297",5258,1,1,2,0.5,0.5
"5298",5259,1,1,2,0.5,0.5
"5299",5260,1,1,2,0.5,0.5
"5300",5261,1,1,2,0.5,0.5
"5301",5262,1,1,2,0.5,0.5
"5302",5263,1,1,2,0.5,0.5
"5303",5264,1,1,2,0.5,0.5
"5304",5265,1,1,2,0.5,0.5
"5305",5266,1,1,2,0.5,0.5
"5306",5267,1,1,2,0.5,0.5
"5307",5268,1,1,2,0.5,0.5
"5308",5269,1,1,2,0.5,0.5
"5309",5270,1,1,2,0.5,0.5
"5310",5271,1,1,2,0.5,0.5
"5311",5272,1,1,2,0.5,0.5
"5312",5273,1,1,2,0.5,0.5
"5313",5274,1,1,2,0.5,0.5
"5314",5275,1,1,2,0.5,0.5
"5315",5276,1,1,2,0.5,0.5
"5316",5277,1,1,2,0.5,0.5
"5317",5278,1,1,2,0.5,0.5
"5318",5279,1,1,2,0.5,0.5
"5319",5280,1,1,2,0.5,0.5
"5320",5281,1,1,2,0.5,0.5
"5321",5282,1,1,2,0.5,0.5
"5322",5283,1,1,2,0.5,0.5
"5323",5284,1,1,2,0.5,0.5
"5324",5285,1,1,2,0.5,0.5
"5325",5286,1,1,2,0.5,0.5
"5326",5287,1,1,2,0.5,0.5
"5327",5288,1,1,2,0.5,0.5
"5328",5289,1,1,2,0.5,0.5
"5329",5290,1,1,2,0.5,0.5
"5330",5291,1,1,2,0.5,0.5
"5331",5292,1,1,2,0.5,0.5
"5332",5293,1,1,2,0.5,0.5
"5333",5294,1,1,2,0.5,0.5
"5334",5295,1,1,2,0.5,0.5
"5335",5296,1,1,2,0.5,0.5
"5336",5297,1,1,2,0.5,0.5
"5337",5298,1,1,2,0.5,0.5
"5338",5299,1,1,2,0.5,0.5
"5339",5300,1,1,2,0.5,0.5
"5340",5301,1,1,2,0.5,0.5
"5341",5302,1,1,2,0.5,0.5
"5342",5303,1,1,2,0.5,0.5
"5343",5304,1,1,2,0.5,0.5
"5344",5305,1,1,2,0.5,0.5
"5345",5306,1,1,2,0.5,0.5
"5346",5307,1,1,2,0.5,0.5
"5347",5308,1,1,2,0.5,0.5
"5348",5309,1,1,2,0.5,0.5
"5349",5310,1,1,2,0.5,0.5
"5350",5311,1,1,2,0.5,0.5
"5351",5312,1,1,2,0.5,0.5
"5352",5313,1,1,2,0.5,0.5
"5353",5314,1,1,2,0.5,0.5
"5354",5315,1,1,2,0.5,0.5
"5355",5316,1,1,2,0.5,0.5
"5356",5317,1,1,2,0.5,0.5
"5357",5318,1,1,2,0.5,0.5
"5358",5319,1,1,2,0.5,0.5
"5359",5320,1,1,2,0.5,0.5
"5360",5321,1,1,2,0.5,0.5
"5361",5322,1,1,2,0.5,0.5
"5362",5323,1,1,2,0.5,0.5
"5363",5324,1,1,2,0.5,0.5
"5364",5325,1,1,2,0.5,0.5
"5365",5326,1,1,2,0.5,0.5
"5366",5327,1,1,2,0.5,0.5
"5367",5328,1,1,2,0.5,0.5
"5368",5329,1,1,2,0.5,0.5
"5369",5330,1,1,2,0.5,0.5
"5370",5331,1,1,2,0.5,0.5
"5371",5332,1,1,2,0.5,0.5
"5372",5333,1,1,2,0.5,0.5
"5373",5334,1,1,2,0.5,0.5
"5374",5335,1,1,2,0.5,0.5
"5375",5336,1,1,2,0.5,0.5
"5376",5337,1,1,2,0.5,0.5
"5377",5338,1,1,2,0.5,0.5
"5378",5339,1,1,2,0.5,0.5
"5379",5340,1,1,2,0.5,0.5
"5380",5341,1,1,2,0.5,0.5
"5381",5342,1,1,2,0.5,0.5
"5382",5343,1,1,2,0.5,0.5
"5383",5344,1,1,2,0.5,0.5
"5384",5345,1,1,2,0.5,0.5
"5385",5346,1,1,2,0.5,0.5
"5386",5347,1,1,2,0.5,0.5
"5387",5348,1,1,2,0.5,0.5
"5388",5349,1,1,2,0.5,0.5
"5389",5350,1,1,2,0.5,0.5
"5390",5351,1,1,2,0.5,0.5
"5391",5352,1,1,2,0.5,0.5
"5392",5353,1,1,2,0.5,0.5
"5393",5354,1,1,2,0.5,0.5
"5394",5355,1,1,2,0.5,0.5
"5395",5356,1,1,2,0.5,0.5
"5396",5357,1,1,2,0.5,0.5
"5397",5358,1,1,2,0.5,0.5
"5398",5359,1,1,2,0.5,0.5
"5399",5360,1,1,2,0.5,0.5
"5400",5361,1,1,2,0.5,0.5
"5401",5362,1,1,2,0.5,0.5
"5402",5363,1,1,2,0.5,0.5
"5403",5364,1,1,2,0.5,0.5
"5404",5365,1,1,2,0.5,0.5
"5405",5366,1,1,2,0.5,0.5
"5406",5367,1,1,2,0.5,0.5
"5407",5368,1,1,2,0.5,0.5
"5408",5369,1,1,2,0.5,0.5
"5409",5370,1,1,2,0.5,0.5
"5410",5371,1,1,2,0.5,0.5
"5411",5372,1,1,2,0.5,0.5
"5412",5373,1,1,2,0.5,0.5
"5413",5374,1,1,2,0.5,0.5
"5414",5375,1,1,2,0.5,0.5
"5415",5376,1,1,2,0.5,0.5
"5416",5377,1,1,2,0.5,0.5
"5417",5378,1,1,2,0.5,0.5
"5418",5379,1,1,2,0.5,0.5
"5419",5380,1,1,2,0.5,0.5
"5420",5381,1,1,2,0.5,0.5
"5421",5382,1,1,2,0.5,0.5
"5422",5383,1,1,2,0.5,0.5
"5423",5384,1,1,2,0.5,0.5
"5424",5385,1,1,2,0.5,0.5
"5425",5386,1,1,2,0.5,0.5
"5426",5387,1,1,2,0.5,0.5
"5427",5388,1,1,2,0.5,0.5
"5428",5389,1,1,2,0.5,0.5
"5429",5390,1,1,2,0.5,0.5
"5430",5391,1,1,2,0.5,0.5
"5431",5392,1,1,2,0.5,0.5
"5432",5393,1,1,2,0.5,0.5
"5433",5394,1,1,2,0.5,0.5
"5434",5395,1,1,2,0.5,0.5
"5435",5396,1,1,2,0.5,0.5
"5436",5397,1,1,2,0.5,0.5
"5437",5398,1,1,2,0.5,0.5
"5438",5399,1,1,2,0.5,0.5
"5439",5400,1,1,2,0.5,0.5
"5440",5401,1,1,2,0.5,0.5
"5441",5402,1,1,2,0.5,0.5
"5442",5403,1,1,2,0.5,0.5
"5443",5404,1,1,2,0.5,0.5
"5444",5405,1,1,2,0.5,0.5
"5445",5406,1,1,2,0.5,0.5
"5446",5407,1,1,2,0.5,0.5
"5447",5408,1,1,2,0.5,0.5
"5448",5409,1,1,2,0.5,0.5
"5449",5410,1,1,2,0.5,0.5
"5450",5411,1,1,2,0.5,0.5
"5451",5412,1,1,2,0.5,0.5
"5452",5413,1,1,2,0.5,0.5
"5453",5414,1,1,2,0.5,0.5
"5454",5415,1,1,2,0.5,0.5
"5455",5416,1,1,2,0.5,0.5
"5456",5417,1,1,2,0.5,0.5
"5457",5418,1,1,2,0.5,0.5
"5458",5419,1,1,2,0.5,0.5
"5459",5420,1,1,2,0.5,0.5
"5460",5421,1,1,2,0.5,0.5
"5461",5422,1,1,2,0.5,0.5
"5462",5423,1,1,2,0.5,0.5
"5463",5425,1,1,2,0.5,0.5
"5464",5426,1,1,2,0.5,0.5
"5465",5427,1,1,2,0.5,0.5
"5466",5428,1,1,2,0.5,0.5
"5467",5429,1,1,2,0.5,0.5
"5468",5430,1,1,2,0.5,0.5
"5469",5431,1,1,2,0.5,0.5
"5470",5432,1,1,2,0.5,0.5
"5471",5433,1,1,2,0.5,0.5
"5472",5434,1,1,2,0.5,0.5
"5473",5435,1,1,2,0.5,0.5
"5474",5436,1,1,2,0.5,0.5
"5475",5437,1,1,2,0.5,0.5
"5476",5438,1,1,2,0.5,0.5
"5477",5439,1,1,2,0.5,0.5
"5478",5440,1,1,2,0.5,0.5
"5479",5441,1,1,2,0.5,0.5
"5480",5442,1,1,2,0.5,0.5
"5481",5443,1,1,2,0.5,0.5
"5482",5444,1,1,2,0.5,0.5
"5483",5445,1,1,2,0.5,0.5
"5484",5446,1,1,2,0.5,0.5
"5485",5447,1,1,2,0.5,0.5
"5486",5448,1,1,2,0.5,0.5
"5487",5449,1,1,2,0.5,0.5
"5488",5450,1,1,2,0.5,0.5
"5489",5451,1,1,2,0.5,0.5
"5490",5452,1,1,2,0.5,0.5
"5491",5453,1,1,2,0.5,0.5
"5492",5454,1,1,2,0.5,0.5
"5493",5455,1,1,2,0.5,0.5
"5494",5456,1,1,2,0.5,0.5
"5495",5457,1,1,2,0.5,0.5
"5496",5458,1,1,2,0.5,0.5
"5497",5460,1,1,2,0.5,0.5
"5498",5461,1,1,2,0.5,0.5
"5499",5462,1,1,2,0.5,0.5
"5500",5463,1,1,2,0.5,0.5
"5501",5464,1,1,2,0.5,0.5
"5502",5465,1,1,2,0.5,0.5
"5503",5466,1,1,2,0.5,0.5
"5504",5467,1,1,2,0.5,0.5
"5505",5468,1,1,2,0.5,0.5
"5506",5469,1,1,2,0.5,0.5
"5507",5470,1,1,2,0.5,0.5
"5508",5471,1,1,2,0.5,0.5
"5509",5472,1,1,2,0.5,0.5
"5510",5473,1,1,2,0.5,0.5
"5511",5474,1,1,2,0.5,0.5
"5512",5475,1,1,2,0.5,0.5
"5513",5476,1,1,2,0.5,0.5
"5514",5477,1,1,2,0.5,0.5
"5515",5478,1,1,2,0.5,0.5
"5516",5479,1,1,2,0.5,0.5
"5517",5480,1,1,2,0.5,0.5
"5518",5481,1,1,2,0.5,0.5
"5519",5482,1,1,2,0.5,0.5
"5520",5483,1,1,2,0.5,0.5
"5521",5484,1,1,2,0.5,0.5
"5522",5485,1,1,2,0.5,0.5
"5523",5486,1,1,2,0.5,0.5
"5524",5487,1,1,2,0.5,0.5
"5525",5488,1,1,2,0.5,0.5
"5526",5489,1,1,2,0.5,0.5
"5527",5490,1,1,2,0.5,0.5
"5528",5491,1,1,2,0.5,0.5
"5529",5492,1,1,2,0.5,0.5
"5530",5493,1,1,2,0.5,0.5
"5531",5494,1,1,2,0.5,0.5
"5532",5495,1,1,2,0.5,0.5
"5533",5496,1,1,2,0.5,0.5
"5534",5497,1,1,2,0.5,0.5
"5535",5498,1,1,2,0.5,0.5
"5536",5499,1,1,2,0.5,0.5
"5537",5500,1,1,2,0.5,0.5
"5538",5501,1,1,2,0.5,0.5
"5539",5502,1,1,2,0.5,0.5
"5540",5503,1,1,2,0.5,0.5
"5541",5504,1,1,2,0.5,0.5
"5542",5505,1,1,2,0.5,0.5
"5543",5506,1,1,2,0.5,0.5
"5544",5507,1,1,2,0.5,0.5
"5545",5508,1,1,2,0.5,0.5
"5546",5509,1,1,2,0.5,0.5
"5547",5510,1,1,2,0.5,0.5
"5548",5511,1,1,2,0.5,0.5
"5549",5512,1,1,2,0.5,0.5
"5550",5513,1,1,2,0.5,0.5
"5551",5514,1,1,2,0.5,0.5
"5552",5515,1,1,2,0.5,0.5
"5553",5516,1,1,2,0.5,0.5
"5554",5517,1,1,2,0.5,0.5
"5555",5518,1,1,2,0.5,0.5
"5556",5519,1,1,2,0.5,0.5
"5557",5520,1,1,2,0.5,0.5
"5558",5521,1,1,2,0.5,0.5
"5559",5522,1,1,2,0.5,0.5
"5560",5523,1,1,2,0.5,0.5
"5561",5524,1,1,2,0.5,0.5
"5562",5525,1,1,2,0.5,0.5
"5563",5526,1,1,2,0.5,0.5
"5564",5527,1,1,2,0.5,0.5
"5565",5528,1,1,2,0.5,0.5
"5566",5529,1,1,2,0.5,0.5
"5567",5530,1,1,2,0.5,0.5
"5568",5531,1,1,2,0.5,0.5
"5569",5532,1,1,2,0.5,0.5
"5570",5533,1,1,2,0.5,0.5
"5571",5534,1,1,2,0.5,0.5
"5572",5535,1,1,2,0.5,0.5
"5573",5536,1,1,2,0.5,0.5
"5574",5537,1,1,2,0.5,0.5
"5575",5538,1,1,2,0.5,0.5
"5576",5539,1,1,2,0.5,0.5
"5577",5540,1,1,2,0.5,0.5
"5578",5542,1,1,2,0.5,0.5
"5579",5543,1,1,2,0.5,0.5
"5580",5544,1,1,2,0.5,0.5
"5581",5545,1,1,2,0.5,0.5
"5582",5546,1,1,2,0.5,0.5
"5583",5547,1,1,2,0.5,0.5
"5584",5548,1,1,2,0.5,0.5
"5585",5549,1,1,2,0.5,0.5
"5586",5550,1,1,2,0.5,0.5
"5587",5551,1,1,2,0.5,0.5
"5588",5552,1,1,2,0.5,0.5
"5589",5553,1,1,2,0.5,0.5
"5590",5554,1,1,2,0.5,0.5
"5591",5555,1,1,2,0.5,0.5
"5592",5556,1,1,2,0.5,0.5
"5593",5557,1,1,2,0.5,0.5
"5594",5558,1,1,2,0.5,0.5
"5595",5559,1,1,2,0.5,0.5
"5596",5560,1,1,2,0.5,0.5
"5597",5561,1,1,2,0.5,0.5
"5598",5562,1,1,2,0.5,0.5
"5599",5564,1,1,2,0.5,0.5
"5600",5565,1,1,2,0.5,0.5
"5601",5566,1,1,2,0.5,0.5
"5602",5567,1,1,2,0.5,0.5
"5603",5568,1,1,2,0.5,0.5
"5604",5569,1,1,2,0.5,0.5
"5605",5570,1,1,2,0.5,0.5
"5606",5571,1,1,2,0.5,0.5
"5607",5572,1,1,2,0.5,0.5
"5608",5573,1,1,2,0.5,0.5
"5609",5574,1,1,2,0.5,0.5
"5610",5575,1,1,2,0.5,0.5
"5611",5576,1,1,2,0.5,0.5
"5612",5577,1,1,2,0.5,0.5
"5613",5578,1,1,2,0.5,0.5
"5614",5579,1,1,2,0.5,0.5
"5615",5580,1,1,2,0.5,0.5
"5616",5581,1,1,2,0.5,0.5
"5617",5582,1,1,2,0.5,0.5
"5618",5583,1,1,2,0.5,0.5
"5619",5584,1,1,2,0.5,0.5
"5620",5585,1,1,2,0.5,0.5
"5621",5586,1,1,2,0.5,0.5
"5622",5587,1,1,2,0.5,0.5
"5623",5588,1,1,2,0.5,0.5
"5624",5589,1,1,2,0.5,0.5
"5625",5590,1,1,2,0.5,0.5
"5626",5591,1,1,2,0.5,0.5
"5627",5592,1,1,2,0.5,0.5
"5628",5593,1,1,2,0.5,0.5
"5629",5594,1,1,2,0.5,0.5
"5630",5595,1,1,2,0.5,0.5
"5631",5596,1,1,2,0.5,0.5
"5632",5597,1,1,2,0.5,0.5
"5633",5598,1,1,2,0.5,0.5
"5634",5599,1,1,2,0.5,0.5
"5635",5600,1,1,2,0.5,0.5
"5636",5601,1,1,2,0.5,0.5
"5637",5602,1,1,2,0.5,0.5
"5638",5603,1,1,2,0.5,0.5
"5639",5604,1,1,2,0.5,0.5
"5640",5605,1,1,2,0.5,0.5
"5641",5606,1,1,2,0.5,0.5
"5642",5607,1,1,2,0.5,0.5
"5643",5608,1,1,2,0.5,0.5
"5644",5609,1,1,2,0.5,0.5
"5645",5610,1,1,2,0.5,0.5
"5646",5611,1,1,2,0.5,0.5
"5647",5612,1,1,2,0.5,0.5
"5648",5613,1,1,2,0.5,0.5
"5649",5614,1,1,2,0.5,0.5
"5650",5615,1,1,2,0.5,0.5
"5651",5616,1,1,2,0.5,0.5
"5652",5617,1,1,2,0.5,0.5
"5653",5618,1,1,2,0.5,0.5
"5654",5619,1,1,2,0.5,0.5
"5655",5621,1,1,2,0.5,0.5
"5656",5622,1,1,2,0.5,0.5
"5657",5623,1,1,2,0.5,0.5
"5658",5624,1,1,2,0.5,0.5
"5659",5625,1,1,2,0.5,0.5
"5660",5626,1,1,2,0.5,0.5
"5661",5627,1,1,2,0.5,0.5
"5662",5628,1,1,2,0.5,0.5
"5663",5629,1,1,2,0.5,0.5
"5664",5630,1,1,2,0.5,0.5
"5665",5632,1,1,2,0.5,0.5
"5666",5633,1,1,2,0.5,0.5
"5667",5634,1,1,2,0.5,0.5
"5668",5635,1,1,2,0.5,0.5
"5669",5636,1,1,2,0.5,0.5
"5670",5637,1,1,2,0.5,0.5
"5671",5638,1,1,2,0.5,0.5
"5672",5639,1,1,2,0.5,0.5
"5673",5640,1,1,2,0.5,0.5
"5674",5641,1,1,2,0.5,0.5
"5675",5642,1,1,2,0.5,0.5
"5676",5643,1,1,2,0.5,0.5
"5677",5644,1,1,2,0.5,0.5
"5678",5645,1,1,2,0.5,0.5
"5679",5646,1,1,2,0.5,0.5
"5680",5647,1,1,2,0.5,0.5
"5681",5648,1,1,2,0.5,0.5
"5682",5649,1,1,2,0.5,0.5
"5683",5650,1,1,2,0.5,0.5
"5684",5651,1,1,2,0.5,0.5
"5685",5652,1,1,2,0.5,0.5
"5686",5653,1,1,2,0.5,0.5
"5687",5654,1,1,2,0.5,0.5
"5688",5655,1,1,2,0.5,0.5
"5689",5656,1,1,2,0.5,0.5
"5690",5657,1,1,2,0.5,0.5
"5691",5658,1,1,2,0.5,0.5
"5692",5659,1,1,2,0.5,0.5
"5693",5660,1,1,2,0.5,0.5
"5694",5661,1,1,2,0.5,0.5
"5695",5662,1,1,2,0.5,0.5
"5696",5663,1,1,2,0.5,0.5
"5697",5664,1,1,2,0.5,0.5
"5698",5665,1,1,2,0.5,0.5
"5699",5666,1,1,2,0.5,0.5
"5700",5667,1,1,2,0.5,0.5
"5701",5668,1,1,2,0.5,0.5
"5702",5669,1,1,2,0.5,0.5
"5703",5670,1,1,2,0.5,0.5
"5704",5671,1,1,2,0.5,0.5
"5705",5672,1,1,2,0.5,0.5
"5706",5673,1,1,2,0.5,0.5
"5707",5674,1,1,2,0.5,0.5
"5708",5675,1,1,2,0.5,0.5
"5709",5676,1,1,2,0.5,0.5
"5710",5677,1,1,2,0.5,0.5
"5711",5678,1,1,2,0.5,0.5
"5712",5679,1,1,2,0.5,0.5
"5713",5680,1,1,2,0.5,0.5
"5714",5681,1,1,2,0.5,0.5
"5715",5682,1,1,2,0.5,0.5
"5716",5683,1,1,2,0.5,0.5
"5717",5684,1,1,2,0.5,0.5
"5718",5685,1,1,2,0.5,0.5
"5719",5686,1,1,2,0.5,0.5
"5720",5687,1,1,2,0.5,0.5
"5721",5688,1,1,2,0.5,0.5
"5722",5689,1,1,2,0.5,0.5
"5723",5690,1,1,2,0.5,0.5
"5724",5691,1,1,2,0.5,0.5
"5725",5692,1,1,2,0.5,0.5
"5726",5693,1,1,2,0.5,0.5
"5727",5694,1,1,2,0.5,0.5
"5728",5695,1,1,2,0.5,0.5
"5729",5696,1,1,2,0.5,0.5
"5730",5697,1,1,2,0.5,0.5
"5731",5698,1,1,2,0.5,0.5
"5732",5699,1,1,2,0.5,0.5
"5733",5700,1,1,2,0.5,0.5
"5734",5701,1,1,2,0.5,0.5
"5735",5702,1,1,2,0.5,0.5
"5736",5703,1,1,2,0.5,0.5
"5737",5704,1,1,2,0.5,0.5
"5738",5705,1,1,2,0.5,0.5
"5739",5706,1,1,2,0.5,0.5
"5740",5707,1,1,2,0.5,0.5
"5741",5708,1,1,2,0.5,0.5
"5742",5709,1,1,2,0.5,0.5
"5743",5710,1,1,2,0.5,0.5
"5744",5711,1,1,2,0.5,0.5
"5745",5712,1,1,2,0.5,0.5
"5746",5713,1,1,2,0.5,0.5
"5747",5714,1,1,2,0.5,0.5
"5748",5715,1,1,2,0.5,0.5
"5749",5716,1,1,2,0.5,0.5
"5750",5717,1,1,2,0.5,0.5
"5751",5718,1,1,2,0.5,0.5
"5752",5719,1,1,2,0.5,0.5
"5753",5720,1,1,2,0.5,0.5
"5754",5721,1,1,2,0.5,0.5
"5755",5722,1,1,2,0.5,0.5
"5756",5723,1,1,2,0.5,0.5
"5757",5724,1,1,2,0.5,0.5
"5758",5725,1,1,2,0.5,0.5
"5759",5726,1,1,2,0.5,0.5
"5760",5727,1,1,2,0.5,0.5
"5761",5728,1,1,2,0.5,0.5
"5762",5729,1,1,2,0.5,0.5
"5763",5730,1,1,2,0.5,0.5
"5764",5731,1,1,2,0.5,0.5
"5765",5732,1,1,2,0.5,0.5
"5766",5733,1,1,2,0.5,0.5
"5767",5734,1,1,2,0.5,0.5
"5768",5735,1,1,2,0.5,0.5
"5769",5736,1,1,2,0.5,0.5
"5770",5737,1,1,2,0.5,0.5
"5771",5738,1,1,2,0.5,0.5
"5772",5739,1,1,2,0.5,0.5
"5773",5740,1,1,2,0.5,0.5
"5774",5741,1,1,2,0.5,0.5
"5775",5742,1,1,2,0.5,0.5
"5776",5743,1,1,2,0.5,0.5
"5777",5744,1,1,2,0.5,0.5
"5778",5745,1,1,2,0.5,0.5
"5779",5746,1,1,2,0.5,0.5
"5780",5747,1,1,2,0.5,0.5
"5781",5748,1,1,2,0.5,0.5
"5782",5749,1,1,2,0.5,0.5
"5783",5750,1,1,2,0.5,0.5
"5784",5751,1,1,2,0.5,0.5
"5785",5752,1,1,2,0.5,0.5
"5786",5753,1,1,2,0.5,0.5
"5787",5754,1,1,2,0.5,0.5
"5788",5755,1,1,2,0.5,0.5
"5789",5756,1,1,2,0.5,0.5
"5790",5757,1,1,2,0.5,0.5
"5791",5758,1,1,2,0.5,0.5
"5792",5759,1,1,2,0.5,0.5
"5793",5760,1,1,2,0.5,0.5
"5794",5761,1,1,2,0.5,0.5
"5795",5762,1,1,2,0.5,0.5
"5796",5763,1,1,2,0.5,0.5
"5797",5764,1,1,2,0.5,0.5
"5798",5765,1,1,2,0.5,0.5
"5799",5766,1,1,2,0.5,0.5
"5800",5767,1,1,2,0.5,0.5
"5801",5768,1,1,2,0.5,0.5
"5802",5769,1,1,2,0.5,0.5
"5803",5770,1,1,2,0.5,0.5
"5804",5771,1,1,2,0.5,0.5
"5805",5772,1,1,2,0.5,0.5
"5806",5773,1,1,2,0.5,0.5
"5807",5774,1,1,2,0.5,0.5
"5808",5775,1,1,2,0.5,0.5
"5809",5776,1,1,2,0.5,0.5
"5810",5777,1,1,2,0.5,0.5
"5811",5778,1,1,2,0.5,0.5
"5812",5779,1,1,2,0.5,0.5
"5813",5780,1,1,2,0.5,0.5
"5814",5781,1,1,2,0.5,0.5
"5815",5782,1,1,2,0.5,0.5
"5816",5783,1,1,2,0.5,0.5
"5817",5784,1,1,2,0.5,0.5
"5818",5785,1,1,2,0.5,0.5
"5819",5786,1,1,2,0.5,0.5
"5820",5787,1,1,2,0.5,0.5
"5821",5788,1,1,2,0.5,0.5
"5822",5789,1,1,2,0.5,0.5
"5823",5790,1,1,2,0.5,0.5
"5824",5791,1,1,2,0.5,0.5
"5825",5792,1,1,2,0.5,0.5
"5826",5793,1,1,2,0.5,0.5
"5827",5794,1,1,2,0.5,0.5
"5828",5795,1,1,2,0.5,0.5
"5829",5796,1,1,2,0.5,0.5
"5830",5797,1,1,2,0.5,0.5
"5831",5798,1,1,2,0.5,0.5
"5832",5799,1,1,2,0.5,0.5
"5833",5800,1,1,2,0.5,0.5
"5834",5801,1,1,2,0.5,0.5
"5835",5802,1,1,2,0.5,0.5
"5836",5803,1,1,2,0.5,0.5
"5837",5804,1,1,2,0.5,0.5
"5838",5805,1,1,2,0.5,0.5
"5839",5806,1,1,2,0.5,0.5
"5840",5807,1,1,2,0.5,0.5
"5841",5808,1,1,2,0.5,0.5
"5842",5809,1,1,2,0.5,0.5
"5843",5811,1,1,2,0.5,0.5
"5844",5812,1,1,2,0.5,0.5
"5845",5813,1,1,2,0.5,0.5
"5846",5814,1,1,2,0.5,0.5
"5847",5815,1,1,2,0.5,0.5
"5848",5816,1,1,2,0.5,0.5
"5849",5817,1,1,2,0.5,0.5
"5850",5818,1,1,2,0.5,0.5
"5851",5819,1,1,2,0.5,0.5
"5852",5820,1,1,2,0.5,0.5
"5853",5821,1,1,2,0.5,0.5
"5854",5822,1,1,2,0.5,0.5
"5855",5823,1,1,2,0.5,0.5
"5856",5824,1,1,2,0.5,0.5
"5857",5825,1,1,2,0.5,0.5
"5858",5826,1,1,2,0.5,0.5
"5859",5827,1,1,2,0.5,0.5
"5860",5828,1,1,2,0.5,0.5
"5861",5829,1,1,2,0.5,0.5
"5862",5830,1,1,2,0.5,0.5
"5863",5831,1,1,2,0.5,0.5
"5864",5832,1,1,2,0.5,0.5
"5865",5833,1,1,2,0.5,0.5
"5866",5834,1,1,2,0.5,0.5
"5867",5835,1,1,2,0.5,0.5
"5868",5836,1,1,2,0.5,0.5
"5869",5837,1,1,2,0.5,0.5
"5870",5838,1,1,2,0.5,0.5
"5871",5839,1,1,2,0.5,0.5
"5872",5840,1,1,2,0.5,0.5
"5873",5841,1,1,2,0.5,0.5
"5874",5842,1,1,2,0.5,0.5
"5875",5843,1,1,2,0.5,0.5
"5876",5844,1,1,2,0.5,0.5
"5877",5845,1,1,2,0.5,0.5
"5878",5846,1,1,2,0.5,0.5
"5879",5847,1,1,2,0.5,0.5
"5880",5848,1,1,2,0.5,0.5
"5881",5849,1,1,2,0.5,0.5
"5882",5850,1,1,2,0.5,0.5
"5883",5851,1,1,2,0.5,0.5
"5884",5852,1,1,2,0.5,0.5
"5885",5853,1,1,2,0.5,0.5
"5886",5854,1,1,2,0.5,0.5
"5887",5855,1,1,2,0.5,0.5
"5888",5856,1,1,2,0.5,0.5
"5889",5857,1,1,2,0.5,0.5
"5890",5858,1,1,2,0.5,0.5
"5891",5859,1,1,2,0.5,0.5
"5892",5860,1,1,2,0.5,0.5
"5893",5861,1,1,2,0.5,0.5
"5894",5862,1,1,2,0.5,0.5
"5895",5863,1,1,2,0.5,0.5
"5896",5864,1,1,2,0.5,0.5
"5897",5865,1,1,2,0.5,0.5
"5898",5866,1,1,2,0.5,0.5
"5899",5867,1,1,2,0.5,0.5
"5900",5868,1,1,2,0.5,0.5
"5901",5869,1,1,2,0.5,0.5
"5902",5870,1,1,2,0.5,0.5
"5903",5871,1,1,2,0.5,0.5
"5904",5872,1,1,2,0.5,0.5
"5905",5873,1,1,2,0.5,0.5
"5906",5874,1,1,2,0.5,0.5
"5907",5875,1,1,2,0.5,0.5
"5908",5876,1,1,2,0.5,0.5
"5909",5877,1,1,2,0.5,0.5
"5910",5878,1,1,2,0.5,0.5
"5911",5879,1,1,2,0.5,0.5
"5912",5880,1,1,2,0.5,0.5
"5913",5881,1,1,2,0.5,0.5
"5914",5882,1,1,2,0.5,0.5
"5915",5883,1,1,2,0.5,0.5
"5916",5884,1,1,2,0.5,0.5
"5917",5885,1,1,2,0.5,0.5
"5918",5886,1,1,2,0.5,0.5
"5919",5887,1,1,2,0.5,0.5
"5920",5888,1,1,2,0.5,0.5
"5921",5889,1,1,2,0.5,0.5
"5922",5890,1,1,2,0.5,0.5
"5923",5891,1,1,2,0.5,0.5
"5924",5892,1,1,2,0.5,0.5
"5925",5893,1,1,2,0.5,0.5
"5926",5894,1,1,2,0.5,0.5
"5927",5895,1,1,2,0.5,0.5
"5928",5896,1,1,2,0.5,0.5
"5929",5897,1,1,2,0.5,0.5
"5930",5898,1,1,2,0.5,0.5
"5931",5899,1,1,2,0.5,0.5
"5932",5900,1,1,2,0.5,0.5
"5933",5901,1,1,2,0.5,0.5
"5934",5902,1,1,2,0.5,0.5
"5935",5903,1,1,2,0.5,0.5
"5936",5904,1,1,2,0.5,0.5
"5937",5905,1,1,2,0.5,0.5
"5938",5906,1,1,2,0.5,0.5
"5939",5907,1,1,2,0.5,0.5
"5940",5908,1,1,2,0.5,0.5
"5941",5909,1,1,2,0.5,0.5
"5942",5910,1,1,2,0.5,0.5
"5943",5911,1,1,2,0.5,0.5
"5944",5912,1,1,2,0.5,0.5
"5945",5913,1,1,2,0.5,0.5
"5946",5914,1,1,2,0.5,0.5
"5947",5915,1,1,2,0.5,0.5
"5948",5916,1,1,2,0.5,0.5
"5949",5917,1,1,2,0.5,0.5
"5950",5918,1,1,2,0.5,0.5
"5951",5919,1,1,2,0.5,0.5
"5952",5920,1,1,2,0.5,0.5
"5953",5921,1,1,2,0.5,0.5
"5954",5922,1,1,2,0.5,0.5
"5955",5923,1,1,2,0.5,0.5
"5956",5924,1,1,2,0.5,0.5
"5957",5925,1,1,2,0.5,0.5
"5958",5926,1,1,2,0.5,0.5
"5959",5927,1,1,2,0.5,0.5
"5960",5928,1,1,2,0.5,0.5
"5961",5929,1,1,2,0.5,0.5
"5962",5930,1,1,2,0.5,0.5
"5963",5931,1,1,2,0.5,0.5
"5964",5932,1,1,2,0.5,0.5
"5965",5933,1,1,2,0.5,0.5
"5966",5934,1,1,2,0.5,0.5
"5967",5935,1,1,2,0.5,0.5
"5968",5936,1,1,2,0.5,0.5
"5969",5937,1,1,2,0.5,0.5
"5970",5938,1,1,2,0.5,0.5
"5971",5939,1,1,2,0.5,0.5
"5972",5940,1,1,2,0.5,0.5
"5973",5941,1,1,2,0.5,0.5
"5974",5942,1,1,2,0.5,0.5
"5975",5943,1,1,2,0.5,0.5
"5976",5944,1,1,2,0.5,0.5
"5977",5945,1,1,2,0.5,0.5
"5978",5946,1,1,2,0.5,0.5
"5979",5947,1,1,2,0.5,0.5
"5980",5948,1,1,2,0.5,0.5
"5981",5949,1,1,2,0.5,0.5
"5982",5950,1,1,2,0.5,0.5
"5983",5951,1,1,2,0.5,0.5
"5984",5952,1,1,2,0.5,0.5
"5985",5953,1,1,2,0.5,0.5
"5986",5954,1,1,2,0.5,0.5
"5987",5955,1,1,2,0.5,0.5
"5988",5956,1,1,2,0.5,0.5
"5989",5957,1,1,2,0.5,0.5
"5990",5958,1,1,2,0.5,0.5
"5991",5959,1,1,2,0.5,0.5
"5992",5960,1,1,2,0.5,0.5
"5993",5961,1,1,2,0.5,0.5
"5994",5962,1,1,2,0.5,0.5
"5995",5963,1,1,2,0.5,0.5
"5996",5964,1,1,2,0.5,0.5
"5997",5965,1,1,2,0.5,0.5
"5998",5966,1,1,2,0.5,0.5
"5999",5967,1,1,2,0.5,0.5
"6000",5968,1,1,2,0.5,0.5
"6001",5969,1,1,2,0.5,0.5
"6002",5970,1,1,2,0.5,0.5
"6003",5971,1,1,2,0.5,0.5
"6004",5972,1,1,2,0.5,0.5
"6005",5973,1,1,2,0.5,0.5
"6006",5974,1,1,2,0.5,0.5
"6007",5975,1,1,2,0.5,0.5
"6008",5976,1,1,2,0.5,0.5
"6009",5977,1,1,2,0.5,0.5
"6010",5978,1,1,2,0.5,0.5
"6011",5979,1,1,2,0.5,0.5
"6012",5980,1,1,2,0.5,0.5
"6013",5981,1,1,2,0.5,0.5
"6014",5982,1,1,2,0.5,0.5
"6015",5983,1,1,2,0.5,0.5
"6016",5984,1,1,2,0.5,0.5
"6017",5985,1,1,2,0.5,0.5
"6018",5986,1,1,2,0.5,0.5
"6019",5987,1,1,2,0.5,0.5
"6020",5988,1,1,2,0.5,0.5
"6021",5989,1,1,2,0.5,0.5
"6022",5990,1,1,2,0.5,0.5
"6023",5992,1,1,2,0.5,0.5
"6024",5993,1,1,2,0.5,0.5
"6025",5994,1,1,2,0.5,0.5
"6026",5995,1,1,2,0.5,0.5
"6027",5996,1,1,2,0.5,0.5
"6028",5997,1,1,2,0.5,0.5
"6029",5998,1,1,2,0.5,0.5
"6030",5999,1,1,2,0.5,0.5
"6031",6000,1,1,2,0.5,0.5
"6032",6001,1,1,2,0.5,0.5
"6033",6002,1,1,2,0.5,0.5
"6034",6003,1,1,2,0.5,0.5
"6035",6004,1,1,2,0.5,0.5
"6036",6005,1,1,2,0.5,0.5
"6037",6006,1,1,2,0.5,0.5
"6038",6007,1,1,2,0.5,0.5
"6039",6008,1,1,2,0.5,0.5
"6040",6009,1,1,2,0.5,0.5
"6041",6010,1,1,2,0.5,0.5
"6042",6011,1,1,2,0.5,0.5
"6043",6012,1,1,2,0.5,0.5
"6044",6013,1,1,2,0.5,0.5
"6045",6014,1,1,2,0.5,0.5
"6046",6015,1,1,2,0.5,0.5
"6047",6016,1,1,2,0.5,0.5
"6048",6017,1,1,2,0.5,0.5
"6049",6018,1,1,2,0.5,0.5
"6050",6019,1,1,2,0.5,0.5
"6051",6020,1,1,2,0.5,0.5
"6052",6021,1,1,2,0.5,0.5
"6053",6022,1,1,2,0.5,0.5
"6054",6023,1,1,2,0.5,0.5
"6055",6024,1,1,2,0.5,0.5
"6056",6025,1,1,2,0.5,0.5
"6057",6026,1,1,2,0.5,0.5
"6058",6027,1,1,2,0.5,0.5
"6059",6028,1,1,2,0.5,0.5
"6060",6029,1,1,2,0.5,0.5
"6061",6030,1,1,2,0.5,0.5
"6062",6031,1,1,2,0.5,0.5
"6063",6032,1,1,2,0.5,0.5
"6064",6033,1,1,2,0.5,0.5
"6065",6034,1,1,2,0.5,0.5
"6066",6035,1,1,2,0.5,0.5
"6067",6036,1,1,2,0.5,0.5
"6068",6037,1,1,2,0.5,0.5
"6069",6038,1,1,2,0.5,0.5
"6070",6039,1,1,2,0.5,0.5
"6071",6040,1,1,2,0.5,0.5
"6072",6041,1,1,2,0.5,0.5
"6073",6042,1,1,2,0.5,0.5
"6074",6043,1,1,2,0.5,0.5
"6075",6044,1,1,2,0.5,0.5
"6076",6045,1,1,2,0.5,0.5
"6077",6046,1,1,2,0.5,0.5
"6078",6047,1,1,2,0.5,0.5
"6079",6048,1,1,2,0.5,0.5
"6080",6049,1,1,2,0.5,0.5
"6081",6050,1,1,2,0.5,0.5
"6082",6051,1,1,2,0.5,0.5
"6083",6052,1,1,2,0.5,0.5
"6084",6053,1,1,2,0.5,0.5
"6085",6054,1,1,2,0.5,0.5
"6086",6055,1,1,2,0.5,0.5
"6087",6056,1,1,2,0.5,0.5
"6088",6057,1,1,2,0.5,0.5
"6089",6058,1,1,2,0.5,0.5
"6090",6059,1,1,2,0.5,0.5
"6091",6060,1,1,2,0.5,0.5
"6092",6061,1,1,2,0.5,0.5
"6093",6062,1,1,2,0.5,0.5
"6094",6063,1,1,2,0.5,0.5
"6095",6064,1,1,2,0.5,0.5
"6096",6065,1,1,2,0.5,0.5
"6097",6066,1,1,2,0.5,0.5
"6098",6067,1,1,2,0.5,0.5
"6099",6068,1,1,2,0.5,0.5
"6100",6069,1,1,2,0.5,0.5
"6101",6070,1,1,2,0.5,0.5
"6102",6071,1,1,2,0.5,0.5
"6103",6072,1,1,2,0.5,0.5
"6104",6073,1,1,2,0.5,0.5
"6105",6074,1,1,2,0.5,0.5
"6106",6075,1,1,2,0.5,0.5
"6107",6076,1,1,2,0.5,0.5
"6108",6077,1,1,2,0.5,0.5
"6109",6078,1,1,2,0.5,0.5
"6110",6079,1,1,2,0.5,0.5
"6111",6080,1,1,2,0.5,0.5
"6112",6081,1,1,2,0.5,0.5
"6113",6082,1,1,2,0.5,0.5
"6114",6083,1,1,2,0.5,0.5
"6115",6084,1,1,2,0.5,0.5
"6116",6085,1,1,2,0.5,0.5
"6117",6086,1,1,2,0.5,0.5
"6118",6087,1,1,2,0.5,0.5
"6119",6088,1,1,2,0.5,0.5
"6120",6089,1,1,2,0.5,0.5
"6121",6090,1,1,2,0.5,0.5
"6122",6091,1,1,2,0.5,0.5
"6123",6092,1,1,2,0.5,0.5
"6124",6093,1,1,2,0.5,0.5
"6125",6094,1,1,2,0.5,0.5
"6126",6095,1,1,2,0.5,0.5
"6127",6096,1,1,2,0.5,0.5
"6128",6097,1,1,2,0.5,0.5
"6129",6098,1,1,2,0.5,0.5
"6130",6099,1,1,2,0.5,0.5
"6131",6100,1,1,2,0.5,0.5
"6132",6101,1,1,2,0.5,0.5
"6133",6102,1,1,2,0.5,0.5
"6134",6103,1,1,2,0.5,0.5
"6135",6104,1,1,2,0.5,0.5
"6136",6105,1,1,2,0.5,0.5
"6137",6106,1,1,2,0.5,0.5
"6138",6107,1,1,2,0.5,0.5
"6139",6108,1,1,2,0.5,0.5
"6140",6109,1,1,2,0.5,0.5
"6141",6110,1,1,2,0.5,0.5
"6142",6111,1,1,2,0.5,0.5
"6143",6112,1,1,2,0.5,0.5
"6144",6113,1,1,2,0.5,0.5
"6145",6114,1,1,2,0.5,0.5
"6146",6115,1,1,2,0.5,0.5
"6147",6116,1,1,2,0.5,0.5
"6148",6117,1,1,2,0.5,0.5
"6149",6118,1,1,2,0.5,0.5
"6150",6119,1,1,2,0.5,0.5
"6151",6120,1,1,2,0.5,0.5
"6152",6121,1,1,2,0.5,0.5
"6153",6122,1,1,2,0.5,0.5
"6154",6123,1,1,2,0.5,0.5
"6155",6124,1,1,2,0.5,0.5
"6156",6125,1,1,2,0.5,0.5
"6157",6126,1,1,2,0.5,0.5
"6158",6127,1,1,2,0.5,0.5
"6159",6128,1,1,2,0.5,0.5
"6160",6129,1,1,2,0.5,0.5
"6161",6130,1,1,2,0.5,0.5
"6162",6131,1,1,2,0.5,0.5
"6163",6132,1,1,2,0.5,0.5
"6164",6133,1,1,2,0.5,0.5
"6165",6134,1,1,2,0.5,0.5
"6166",6135,1,1,2,0.5,0.5
"6167",6136,1,1,2,0.5,0.5
"6168",6137,1,1,2,0.5,0.5
"6169",6138,1,1,2,0.5,0.5
"6170",6139,1,1,2,0.5,0.5
"6171",6140,1,1,2,0.5,0.5
"6172",6141,1,1,2,0.5,0.5
"6173",6142,1,1,2,0.5,0.5
"6174",6143,1,1,2,0.5,0.5
"6175",6144,1,1,2,0.5,0.5
"6176",6145,1,1,2,0.5,0.5
"6177",6146,1,1,2,0.5,0.5
"6178",6147,1,1,2,0.5,0.5
"6179",6148,1,1,2,0.5,0.5
"6180",6149,1,1,2,0.5,0.5
"6181",6150,1,1,2,0.5,0.5
"6182",6151,1,1,2,0.5,0.5
"6183",6152,1,1,2,0.5,0.5
"6184",6153,1,1,2,0.5,0.5
"6185",6154,1,1,2,0.5,0.5
"6186",6155,1,1,2,0.5,0.5
"6187",6156,1,1,2,0.5,0.5
"6188",6157,1,1,2,0.5,0.5
"6189",6158,1,1,2,0.5,0.5
"6190",6159,1,1,2,0.5,0.5
"6191",6160,1,1,2,0.5,0.5
"6192",6161,1,1,2,0.5,0.5
"6193",6162,1,1,2,0.5,0.5
"6194",6163,1,1,2,0.5,0.5
"6195",6164,1,1,2,0.5,0.5
"6196",6165,1,1,2,0.5,0.5
"6197",6166,1,1,2,0.5,0.5
"6198",6167,1,1,2,0.5,0.5
"6199",6168,1,1,2,0.5,0.5
"6200",6169,1,1,2,0.5,0.5
"6201",6170,1,1,2,0.5,0.5
"6202",6171,1,1,2,0.5,0.5
"6203",6172,1,1,2,0.5,0.5
"6204",6173,1,1,2,0.5,0.5
"6205",6174,1,1,2,0.5,0.5
"6206",6175,1,1,2,0.5,0.5
"6207",6176,1,1,2,0.5,0.5
"6208",6177,1,1,2,0.5,0.5
"6209",6178,1,1,2,0.5,0.5
"6210",6179,1,1,2,0.5,0.5
"6211",6180,1,1,2,0.5,0.5
"6212",6181,1,1,2,0.5,0.5
"6213",6182,1,1,2,0.5,0.5
"6214",6183,1,1,2,0.5,0.5
"6215",6184,1,1,2,0.5,0.5
"6216",6185,1,1,2,0.5,0.5
"6217",6186,1,1,2,0.5,0.5
"6218",6187,1,1,2,0.5,0.5
"6219",6188,1,1,2,0.5,0.5
"6220",6189,1,1,2,0.5,0.5
"6221",6190,1,1,2,0.5,0.5
"6222",6191,1,1,2,0.5,0.5
"6223",6192,1,1,2,0.5,0.5
"6224",6193,1,1,2,0.5,0.5
"6225",6194,1,1,2,0.5,0.5
"6226",6195,1,1,2,0.5,0.5
"6227",6196,1,1,2,0.5,0.5
"6228",6197,1,1,2,0.5,0.5
"6229",6198,1,1,2,0.5,0.5
"6230",6199,1,1,2,0.5,0.5
"6231",6200,1,1,2,0.5,0.5
"6232",6201,1,1,2,0.5,0.5
"6233",6202,1,1,2,0.5,0.5
"6234",6203,1,1,2,0.5,0.5
"6235",6204,1,1,2,0.5,0.5
"6236",6205,1,1,2,0.5,0.5
"6237",6206,1,1,2,0.5,0.5
"6238",6207,1,1,2,0.5,0.5
"6239",6208,1,1,2,0.5,0.5
"6240",6209,1,1,2,0.5,0.5
"6241",6210,1,1,2,0.5,0.5
"6242",6211,1,1,2,0.5,0.5
"6243",6212,1,1,2,0.5,0.5
"6244",6213,1,1,2,0.5,0.5
"6245",6214,1,1,2,0.5,0.5
"6246",6215,1,1,2,0.5,0.5
"6247",6216,1,1,2,0.5,0.5
"6248",6217,1,1,2,0.5,0.5
"6249",6218,1,1,2,0.5,0.5
"6250",6219,1,1,2,0.5,0.5
"6251",6220,1,1,2,0.5,0.5
"6252",6221,1,1,2,0.5,0.5
"6253",6222,1,1,2,0.5,0.5
"6254",6223,1,1,2,0.5,0.5
"6255",6224,1,1,2,0.5,0.5
"6256",6225,1,1,2,0.5,0.5
"6257",6226,1,1,2,0.5,0.5
"6258",6227,1,1,2,0.5,0.5
"6259",6228,1,1,2,0.5,0.5
"6260",6229,1,1,2,0.5,0.5
"6261",6230,1,1,2,0.5,0.5
"6262",6231,1,1,2,0.5,0.5
"6263",6232,1,1,2,0.5,0.5
"6264",6233,1,1,2,0.5,0.5
"6265",6234,1,1,2,0.5,0.5
"6266",6235,1,1,2,0.5,0.5
"6267",6236,1,1,2,0.5,0.5
"6268",6237,1,1,2,0.5,0.5
"6269",6238,1,1,2,0.5,0.5
"6270",6239,1,1,2,0.5,0.5
"6271",6240,1,1,2,0.5,0.5
"6272",6241,1,1,2,0.5,0.5
"6273",6242,1,1,2,0.5,0.5
"6274",6243,1,1,2,0.5,0.5
"6275",6244,1,1,2,0.5,0.5
"6276",6245,1,1,2,0.5,0.5
"6277",6246,1,1,2,0.5,0.5
"6278",6247,1,1,2,0.5,0.5
"6279",6248,1,1,2,0.5,0.5
"6280",6249,1,1,2,0.5,0.5
"6281",6250,1,1,2,0.5,0.5
"6282",6252,1,1,2,0.5,0.5
"6283",6253,1,1,2,0.5,0.5
"6284",6254,1,1,2,0.5,0.5
"6285",6255,1,1,2,0.5,0.5
"6286",6256,1,1,2,0.5,0.5
"6287",6257,1,1,2,0.5,0.5
"6288",6258,1,1,2,0.5,0.5
"6289",6259,1,1,2,0.5,0.5
"6290",6260,1,1,2,0.5,0.5
"6291",6261,1,1,2,0.5,0.5
"6292",6262,1,1,2,0.5,0.5
"6293",6263,1,1,2,0.5,0.5
"6294",6264,1,1,2,0.5,0.5
"6295",6265,1,1,2,0.5,0.5
"6296",6266,1,1,2,0.5,0.5
"6297",6267,1,1,2,0.5,0.5
"6298",6268,1,1,2,0.5,0.5
"6299",6269,1,1,2,0.5,0.5
"6300",6270,1,1,2,0.5,0.5
"6301",6271,1,1,2,0.5,0.5
"6302",6272,1,1,2,0.5,0.5
"6303",6273,1,1,2,0.5,0.5
"6304",6274,1,1,2,0.5,0.5
"6305",6275,1,1,2,0.5,0.5
"6306",6276,1,1,2,0.5,0.5
"6307",6277,1,1,2,0.5,0.5
"6308",6278,1,1,2,0.5,0.5
"6309",6279,1,1,2,0.5,0.5
"6310",6281,1,1,2,0.5,0.5
"6311",6282,1,1,2,0.5,0.5
"6312",6283,1,1,2,0.5,0.5
"6313",6284,1,1,2,0.5,0.5
"6314",6285,1,1,2,0.5,0.5
"6315",6286,1,1,2,0.5,0.5
"6316",6287,1,1,2,0.5,0.5
"6317",6288,1,1,2,0.5,0.5
"6318",6289,1,1,2,0.5,0.5
"6319",6290,1,1,2,0.5,0.5
"6320",6291,1,1,2,0.5,0.5
"6321",6292,1,1,2,0.5,0.5
"6322",6293,1,1,2,0.5,0.5
"6323",6294,1,1,2,0.5,0.5
"6324",6295,1,1,2,0.5,0.5
"6325",6296,1,1,2,0.5,0.5
"6326",6297,1,1,2,0.5,0.5
"6327",6298,1,1,2,0.5,0.5
"6328",6299,1,1,2,0.5,0.5
"6329",6300,1,1,2,0.5,0.5
"6330",6301,1,1,2,0.5,0.5
"6331",6302,1,1,2,0.5,0.5
"6332",6303,1,1,2,0.5,0.5
"6333",6304,1,1,2,0.5,0.5
"6334",6305,1,1,2,0.5,0.5
"6335",6306,1,1,2,0.5,0.5
"6336",6307,1,1,2,0.5,0.5
"6337",6308,1,1,2,0.5,0.5
"6338",6309,1,1,2,0.5,0.5
"6339",6310,1,1,2,0.5,0.5
"6340",6311,1,1,2,0.5,0.5
"6341",6312,1,1,2,0.5,0.5
"6342",6313,1,1,2,0.5,0.5
"6343",6314,1,1,2,0.5,0.5
"6344",6315,1,1,2,0.5,0.5
"6345",6316,1,1,2,0.5,0.5
"6346",6317,1,1,2,0.5,0.5
"6347",6318,1,1,2,0.5,0.5
"6348",6319,1,1,2,0.5,0.5
"6349",6320,1,1,2,0.5,0.5
"6350",6321,1,1,2,0.5,0.5
"6351",6322,1,1,2,0.5,0.5
"6352",6323,1,1,2,0.5,0.5
"6353",6324,1,1,2,0.5,0.5
"6354",6325,1,1,2,0.5,0.5
"6355",6326,1,1,2,0.5,0.5
"6356",6327,1,1,2,0.5,0.5
"6357",6328,1,1,2,0.5,0.5
"6358",6329,1,1,2,0.5,0.5
"6359",6330,1,1,2,0.5,0.5
"6360",6331,1,1,2,0.5,0.5
"6361",6332,1,1,2,0.5,0.5
"6362",6333,1,1,2,0.5,0.5
"6363",6335,1,1,2,0.5,0.5
"6364",6336,1,1,2,0.5,0.5
"6365",6337,1,1,2,0.5,0.5
"6366",6338,1,1,2,0.5,0.5
"6367",6339,1,1,2,0.5,0.5
"6368",6340,1,1,2,0.5,0.5
"6369",6341,1,1,2,0.5,0.5
"6370",6342,1,1,2,0.5,0.5
"6371",6343,1,1,2,0.5,0.5
"6372",6344,1,1,2,0.5,0.5
"6373",6345,1,1,2,0.5,0.5
"6374",6346,1,1,2,0.5,0.5
"6375",6347,1,1,2,0.5,0.5
"6376",6348,1,1,2,0.5,0.5
"6377",6349,1,1,2,0.5,0.5
"6378",6350,1,1,2,0.5,0.5
"6379",6351,1,1,2,0.5,0.5
"6380",6352,1,1,2,0.5,0.5
"6381",6353,1,1,2,0.5,0.5
"6382",6354,1,1,2,0.5,0.5
"6383",6355,1,1,2,0.5,0.5
"6384",6356,1,1,2,0.5,0.5
"6385",6357,1,1,2,0.5,0.5
"6386",6358,1,1,2,0.5,0.5
"6387",6359,1,1,2,0.5,0.5
"6388",6360,1,1,2,0.5,0.5
"6389",6361,1,1,2,0.5,0.5
"6390",6362,1,1,2,0.5,0.5
"6391",6363,1,1,2,0.5,0.5
"6392",6364,1,1,2,0.5,0.5
"6393",6365,1,1,2,0.5,0.5
"6394",6366,1,1,2,0.5,0.5
"6395",6367,1,1,2,0.5,0.5
"6396",6368,1,1,2,0.5,0.5
"6397",6369,1,1,2,0.5,0.5
"6398",6370,1,1,2,0.5,0.5
"6399",6371,1,1,2,0.5,0.5
"6400",6372,1,1,2,0.5,0.5
"6401",6373,1,1,2,0.5,0.5
"6402",6374,1,1,2,0.5,0.5
"6403",6375,1,1,2,0.5,0.5
"6404",6376,1,1,2,0.5,0.5
"6405",6377,1,1,2,0.5,0.5
"6406",6378,1,1,2,0.5,0.5
"6407",6379,1,1,2,0.5,0.5
"6408",6380,1,1,2,0.5,0.5
"6409",6381,1,1,2,0.5,0.5
"6410",6382,1,1,2,0.5,0.5
"6411",6383,1,1,2,0.5,0.5
"6412",6384,1,1,2,0.5,0.5
"6413",6385,1,1,2,0.5,0.5
"6414",6386,1,1,2,0.5,0.5
"6415",6387,1,1,2,0.5,0.5
"6416",6388,1,1,2,0.5,0.5
"6417",6389,1,1,2,0.5,0.5
"6418",6390,1,1,2,0.5,0.5
"6419",6391,1,1,2,0.5,0.5
"6420",6392,1,1,2,0.5,0.5
"6421",6393,1,1,2,0.5,0.5
"6422",6394,1,1,2,0.5,0.5
"6423",6395,1,1,2,0.5,0.5
"6424",6396,1,1,2,0.5,0.5
"6425",6397,1,1,2,0.5,0.5
"6426",6398,1,1,2,0.5,0.5
"6427",6399,1,1,2,0.5,0.5
"6428",6400,1,1,2,0.5,0.5
"6429",6401,1,1,2,0.5,0.5
"6430",6402,1,1,2,0.5,0.5
"6431",6403,1,1,2,0.5,0.5
"6432",6404,1,1,2,0.5,0.5
"6433",6405,1,1,2,0.5,0.5
"6434",6406,1,1,2,0.5,0.5
"6435",6407,1,1,2,0.5,0.5
"6436",6408,1,1,2,0.5,0.5
"6437",6409,1,1,2,0.5,0.5
"6438",6410,1,1,2,0.5,0.5
"6439",6411,1,1,2,0.5,0.5
"6440",6412,1,1,2,0.5,0.5
"6441",6413,1,1,2,0.5,0.5
"6442",6414,1,1,2,0.5,0.5
"6443",6415,1,1,2,0.5,0.5
"6444",6416,1,1,2,0.5,0.5
"6445",6417,1,1,2,0.5,0.5
"6446",6418,1,1,2,0.5,0.5
"6447",6419,1,1,2,0.5,0.5
"6448",6420,1,1,2,0.5,0.5
"6449",6421,1,1,2,0.5,0.5
"6450",6422,1,1,2,0.5,0.5
"6451",6423,1,1,2,0.5,0.5
"6452",6424,1,1,2,0.5,0.5
"6453",6425,1,1,2,0.5,0.5
"6454",6426,1,1,2,0.5,0.5
"6455",6427,1,1,2,0.5,0.5
"6456",6428,1,1,2,0.5,0.5
"6457",6429,1,1,2,0.5,0.5
"6458",6430,1,1,2,0.5,0.5
"6459",6431,1,1,2,0.5,0.5
"6460",6432,1,1,2,0.5,0.5
"6461",6433,1,1,2,0.5,0.5
"6462",6434,1,1,2,0.5,0.5
"6463",6435,1,1,2,0.5,0.5
"6464",6436,1,1,2,0.5,0.5
"6465",6437,1,1,2,0.5,0.5
"6466",6438,1,1,2,0.5,0.5
"6467",6439,1,1,2,0.5,0.5
"6468",6440,1,1,2,0.5,0.5
"6469",6441,1,1,2,0.5,0.5
"6470",6442,1,1,2,0.5,0.5
"6471",6443,1,1,2,0.5,0.5
"6472",6444,1,1,2,0.5,0.5
"6473",6445,1,1,2,0.5,0.5
"6474",6446,1,1,2,0.5,0.5
"6475",6447,1,1,2,0.5,0.5
"6476",6448,1,1,2,0.5,0.5
"6477",6449,1,1,2,0.5,0.5
"6478",6450,1,1,2,0.5,0.5
"6479",6451,1,1,2,0.5,0.5
"6480",6452,1,1,2,0.5,0.5
"6481",6453,1,1,2,0.5,0.5
"6482",6454,1,1,2,0.5,0.5
"6483",6455,1,1,2,0.5,0.5
"6484",6456,1,1,2,0.5,0.5
"6485",6457,1,1,2,0.5,0.5
"6486",6458,1,1,2,0.5,0.5
"6487",6459,1,1,2,0.5,0.5
"6488",6460,1,1,2,0.5,0.5
"6489",6461,1,1,2,0.5,0.5
"6490",6462,1,1,2,0.5,0.5
"6491",6463,1,1,2,0.5,0.5
"6492",6464,1,1,2,0.5,0.5
"6493",6465,1,1,2,0.5,0.5
"6494",6466,1,1,2,0.5,0.5
"6495",6467,1,1,2,0.5,0.5
"6496",6468,1,1,2,0.5,0.5
"6497",6469,1,1,2,0.5,0.5
"6498",6470,1,1,2,0.5,0.5
"6499",6471,1,1,2,0.5,0.5
"6500",6472,1,1,2,0.5,0.5
"6501",6473,1,1,2,0.5,0.5
"6502",6474,1,1,2,0.5,0.5
"6503",6475,1,1,2,0.5,0.5
"6504",6476,1,1,2,0.5,0.5
"6505",6477,1,1,2,0.5,0.5
"6506",6478,1,1,2,0.5,0.5
"6507",6479,1,1,2,0.5,0.5
"6508",6480,1,1,2,0.5,0.5
"6509",6481,1,1,2,0.5,0.5
"6510",6482,1,1,2,0.5,0.5
"6511",6483,1,1,2,0.5,0.5
"6512",6484,1,1,2,0.5,0.5
"6513",6485,1,1,2,0.5,0.5
"6514",6486,1,1,2,0.5,0.5
"6515",6487,1,1,2,0.5,0.5
"6516",6488,1,1,2,0.5,0.5
"6517",6489,1,1,2,0.5,0.5
"6518",6490,1,1,2,0.5,0.5
"6519",6491,1,1,2,0.5,0.5
"6520",6492,1,1,2,0.5,0.5
"6521",6493,1,1,2,0.5,0.5
"6522",6494,1,1,2,0.5,0.5
"6523",6495,1,1,2,0.5,0.5
"6524",6496,1,1,2,0.5,0.5
"6525",6497,1,1,2,0.5,0.5
"6526",6498,1,1,2,0.5,0.5
"6527",6499,1,1,2,0.5,0.5
"6528",6500,1,1,2,0.5,0.5
"6529",6501,1,1,2,0.5,0.5
"6530",6502,1,1,2,0.5,0.5
"6531",6503,1,1,2,0.5,0.5
"6532",6504,1,1,2,0.5,0.5
"6533",6505,1,1,2,0.5,0.5
"6534",6506,1,1,2,0.5,0.5
"6535",6507,1,1,2,0.5,0.5
"6536",6508,1,1,2,0.5,0.5
"6537",6509,1,1,2,0.5,0.5
"6538",6510,1,1,2,0.5,0.5
"6539",6511,1,1,2,0.5,0.5
"6540",6512,1,1,2,0.5,0.5
"6541",6513,1,1,2,0.5,0.5
"6542",6514,1,1,2,0.5,0.5
"6543",6515,1,1,2,0.5,0.5
"6544",6516,1,1,2,0.5,0.5
"6545",6517,1,1,2,0.5,0.5
"6546",6518,1,1,2,0.5,0.5
"6547",6519,1,1,2,0.5,0.5
"6548",6520,1,1,2,0.5,0.5
"6549",6521,1,1,2,0.5,0.5
"6550",6522,1,1,2,0.5,0.5
"6551",6523,1,1,2,0.5,0.5
"6552",6524,1,1,2,0.5,0.5
"6553",6525,1,1,2,0.5,0.5
"6554",6526,1,1,2,0.5,0.5
"6555",6527,1,1,2,0.5,0.5
"6556",6528,1,1,2,0.5,0.5
"6557",6529,1,1,2,0.5,0.5
"6558",6530,1,1,2,0.5,0.5
"6559",6531,1,1,2,0.5,0.5
"6560",6532,1,1,2,0.5,0.5
"6561",6533,1,1,2,0.5,0.5
"6562",6534,1,1,2,0.5,0.5
"6563",6535,1,1,2,0.5,0.5
"6564",6536,1,1,2,0.5,0.5
"6565",6537,1,1,2,0.5,0.5
"6566",6538,1,1,2,0.5,0.5
"6567",6539,1,1,2,0.5,0.5
"6568",6540,1,1,2,0.5,0.5
"6569",6541,1,1,2,0.5,0.5
"6570",6542,1,1,2,0.5,0.5
"6571",6543,1,1,2,0.5,0.5
"6572",6544,1,1,2,0.5,0.5
"6573",6545,1,1,2,0.5,0.5
"6574",6546,1,1,2,0.5,0.5
"6575",6547,1,1,2,0.5,0.5
"6576",6548,1,1,2,0.5,0.5
"6577",6549,1,1,2,0.5,0.5
"6578",6550,1,1,2,0.5,0.5
"6579",6551,1,1,2,0.5,0.5
"6580",6552,1,1,2,0.5,0.5
"6581",6553,1,1,2,0.5,0.5
"6582",6554,1,1,2,0.5,0.5
"6583",6555,1,1,2,0.5,0.5
"6584",6556,1,1,2,0.5,0.5
"6585",6557,1,1,2,0.5,0.5
"6586",6558,1,1,2,0.5,0.5
"6587",6559,1,1,2,0.5,0.5
"6588",6560,1,1,2,0.5,0.5
"6589",6562,1,1,2,0.5,0.5
"6590",6563,1,1,2,0.5,0.5
"6591",6564,1,1,2,0.5,0.5
"6592",6565,1,1,2,0.5,0.5
"6593",6566,1,1,2,0.5,0.5
"6594",6567,1,1,2,0.5,0.5
"6595",6568,1,1,2,0.5,0.5
"6596",6569,1,1,2,0.5,0.5
"6597",6570,1,1,2,0.5,0.5
"6598",6571,1,1,2,0.5,0.5
"6599",6572,1,1,2,0.5,0.5
"6600",6573,1,1,2,0.5,0.5
"6601",6574,1,1,2,0.5,0.5
"6602",6575,1,1,2,0.5,0.5
"6603",6576,1,1,2,0.5,0.5
"6604",6577,1,1,2,0.5,0.5
"6605",6578,1,1,2,0.5,0.5
"6606",6579,1,1,2,0.5,0.5
"6607",6580,1,1,2,0.5,0.5
"6608",6581,1,1,2,0.5,0.5
"6609",6582,1,1,2,0.5,0.5
"6610",6583,1,1,2,0.5,0.5
"6611",6584,1,1,2,0.5,0.5
"6612",6585,1,1,2,0.5,0.5
"6613",6586,1,1,2,0.5,0.5
"6614",6587,1,1,2,0.5,0.5
"6615",6588,1,1,2,0.5,0.5
"6616",6590,1,1,2,0.5,0.5
"6617",6591,1,1,2,0.5,0.5
"6618",6592,1,1,2,0.5,0.5
"6619",6593,1,1,2,0.5,0.5
"6620",6594,1,1,2,0.5,0.5
"6621",6595,1,1,2,0.5,0.5
"6622",6596,1,1,2,0.5,0.5
"6623",6597,1,1,2,0.5,0.5
"6624",6598,1,1,2,0.5,0.5
"6625",6599,1,1,2,0.5,0.5
"6626",6600,1,1,2,0.5,0.5
"6627",6601,1,1,2,0.5,0.5
"6628",6602,1,1,2,0.5,0.5
"6629",6603,1,1,2,0.5,0.5
"6630",6604,1,1,2,0.5,0.5
"6631",6605,1,1,2,0.5,0.5
"6632",6606,1,1,2,0.5,0.5
"6633",6607,1,1,2,0.5,0.5
"6634",6608,1,1,2,0.5,0.5
"6635",6609,1,1,2,0.5,0.5
"6636",6610,1,1,2,0.5,0.5
"6637",6611,1,1,2,0.5,0.5
"6638",6612,1,1,2,0.5,0.5
"6639",6613,1,1,2,0.5,0.5
"6640",6614,1,1,2,0.5,0.5
"6641",6615,1,1,2,0.5,0.5
"6642",6616,1,1,2,0.5,0.5
"6643",6617,1,1,2,0.5,0.5
"6644",6618,1,1,2,0.5,0.5
"6645",6619,1,1,2,0.5,0.5
"6646",6620,1,1,2,0.5,0.5
"6647",6621,1,1,2,0.5,0.5
"6648",6622,1,1,2,0.5,0.5
"6649",6623,1,1,2,0.5,0.5
"6650",6624,1,1,2,0.5,0.5
"6651",6625,1,1,2,0.5,0.5
"6652",6626,1,1,2,0.5,0.5
"6653",6627,1,1,2,0.5,0.5
"6654",6628,1,1,2,0.5,0.5
"6655",6629,1,1,2,0.5,0.5
"6656",6630,1,1,2,0.5,0.5
"6657",6631,1,1,2,0.5,0.5
"6658",6632,1,1,2,0.5,0.5
"6659",6633,1,1,2,0.5,0.5
"6660",6634,1,1,2,0.5,0.5
"6661",6635,1,1,2,0.5,0.5
"6662",6636,1,1,2,0.5,0.5
"6663",6637,1,1,2,0.5,0.5
"6664",6638,1,1,2,0.5,0.5
"6665",6639,1,1,2,0.5,0.5
"6666",6640,1,1,2,0.5,0.5
"6667",6641,1,1,2,0.5,0.5
"6668",6642,1,1,2,0.5,0.5
"6669",6643,1,1,2,0.5,0.5
"6670",6644,1,1,2,0.5,0.5
"6671",6646,1,1,2,0.5,0.5
"6672",6647,1,1,2,0.5,0.5
"6673",6648,1,1,2,0.5,0.5
"6674",6649,1,1,2,0.5,0.5
"6675",6650,1,1,2,0.5,0.5
"6676",6651,1,1,2,0.5,0.5
"6677",6653,1,1,2,0.5,0.5
"6678",6654,1,1,2,0.5,0.5
"6679",6655,1,1,2,0.5,0.5
"6680",6656,1,1,2,0.5,0.5
"6681",6657,1,1,2,0.5,0.5
"6682",6658,1,1,2,0.5,0.5
"6683",6659,1,1,2,0.5,0.5
"6684",6660,1,1,2,0.5,0.5
"6685",6661,1,1,2,0.5,0.5
"6686",6662,1,1,2,0.5,0.5
"6687",6663,1,1,2,0.5,0.5
"6688",6664,1,1,2,0.5,0.5
"6689",6665,1,1,2,0.5,0.5
"6690",6666,1,1,2,0.5,0.5
"6691",6667,1,1,2,0.5,0.5
"6692",6668,1,1,2,0.5,0.5
"6693",6669,1,1,2,0.5,0.5
"6694",6670,1,1,2,0.5,0.5
"6695",6671,1,1,2,0.5,0.5
"6696",6672,1,1,2,0.5,0.5
"6697",6673,1,1,2,0.5,0.5
"6698",6674,1,1,2,0.5,0.5
"6699",6675,1,1,2,0.5,0.5
"6700",6676,1,1,2,0.5,0.5
"6701",6677,1,1,2,0.5,0.5
"6702",6678,1,1,2,0.5,0.5
"6703",6679,1,1,2,0.5,0.5
"6704",6680,1,1,2,0.5,0.5
"6705",6681,1,1,2,0.5,0.5
"6706",6682,1,1,2,0.5,0.5
"6707",6683,1,1,2,0.5,0.5
"6708",6684,1,1,2,0.5,0.5
"6709",6685,1,1,2,0.5,0.5
"6710",6686,1,1,2,0.5,0.5
"6711",6687,1,1,2,0.5,0.5
"6712",6688,1,1,2,0.5,0.5
"6713",6689,1,1,2,0.5,0.5
"6714",6690,1,1,2,0.5,0.5
"6715",6691,1,1,2,0.5,0.5
"6716",6692,1,1,2,0.5,0.5
"6717",6693,1,1,2,0.5,0.5
"6718",6694,1,1,2,0.5,0.5
"6719",6695,1,1,2,0.5,0.5
"6720",6696,1,1,2,0.5,0.5
"6721",6697,1,1,2,0.5,0.5
"6722",6698,1,1,2,0.5,0.5
"6723",6699,1,1,2,0.5,0.5
"6724",6700,1,1,2,0.5,0.5
"6725",6701,1,1,2,0.5,0.5
"6726",6702,1,1,2,0.5,0.5
"6727",6703,1,1,2,0.5,0.5
"6728",6704,1,1,2,0.5,0.5
"6729",6705,1,1,2,0.5,0.5
"6730",6706,1,1,2,0.5,0.5
"6731",6707,1,1,2,0.5,0.5
"6732",6708,1,1,2,0.5,0.5
"6733",6709,1,1,2,0.5,0.5
"6734",6710,1,1,2,0.5,0.5
"6735",6712,1,1,2,0.5,0.5
"6736",6713,1,1,2,0.5,0.5
"6737",6714,1,1,2,0.5,0.5
"6738",6715,1,1,2,0.5,0.5
"6739",6716,1,1,2,0.5,0.5
"6740",6717,1,1,2,0.5,0.5
"6741",6718,1,1,2,0.5,0.5
"6742",6719,1,1,2,0.5,0.5
"6743",6720,1,1,2,0.5,0.5
"6744",6721,1,1,2,0.5,0.5
"6745",6722,1,1,2,0.5,0.5
"6746",6723,1,1,2,0.5,0.5
"6747",6724,1,1,2,0.5,0.5
"6748",6725,1,1,2,0.5,0.5
"6749",6726,1,1,2,0.5,0.5
"6750",6727,1,1,2,0.5,0.5
"6751",6728,1,1,2,0.5,0.5
"6752",6729,1,1,2,0.5,0.5
"6753",6730,1,1,2,0.5,0.5
"6754",6731,1,1,2,0.5,0.5
"6755",6732,1,1,2,0.5,0.5
"6756",6733,1,1,2,0.5,0.5
"6757",6734,1,1,2,0.5,0.5
"6758",6735,1,1,2,0.5,0.5
"6759",6736,1,1,2,0.5,0.5
"6760",6737,1,1,2,0.5,0.5
"6761",6738,1,1,2,0.5,0.5
"6762",6739,1,1,2,0.5,0.5
"6763",6740,1,1,2,0.5,0.5
"6764",6741,1,1,2,0.5,0.5
"6765",6742,1,1,2,0.5,0.5
"6766",6743,1,1,2,0.5,0.5
"6767",6744,1,1,2,0.5,0.5
"6768",6745,1,1,2,0.5,0.5
"6769",6746,1,1,2,0.5,0.5
"6770",6747,1,1,2,0.5,0.5
"6771",6748,1,1,2,0.5,0.5
"6772",6750,1,1,2,0.5,0.5
"6773",6751,1,1,2,0.5,0.5
"6774",6752,1,1,2,0.5,0.5
"6775",6753,1,1,2,0.5,0.5
"6776",6754,1,1,2,0.5,0.5
"6777",6755,1,1,2,0.5,0.5
"6778",6756,1,1,2,0.5,0.5
"6779",6757,1,1,2,0.5,0.5
"6780",6759,1,1,2,0.5,0.5
"6781",6760,1,1,2,0.5,0.5
"6782",6761,1,1,2,0.5,0.5
"6783",6762,1,1,2,0.5,0.5
"6784",6763,1,1,2,0.5,0.5
"6785",6764,1,1,2,0.5,0.5
"6786",6765,1,1,2,0.5,0.5
"6787",6766,1,1,2,0.5,0.5
"6788",6767,1,1,2,0.5,0.5
"6789",6768,1,1,2,0.5,0.5
"6790",6769,1,1,2,0.5,0.5
"6791",6770,1,1,2,0.5,0.5
"6792",6771,1,1,2,0.5,0.5
"6793",6772,1,1,2,0.5,0.5
"6794",6773,1,1,2,0.5,0.5
"6795",6774,1,1,2,0.5,0.5
"6796",6775,1,1,2,0.5,0.5
"6797",6776,1,1,2,0.5,0.5
"6798",6777,1,1,2,0.5,0.5
"6799",6778,1,1,2,0.5,0.5
"6800",6779,1,1,2,0.5,0.5
"6801",6780,1,1,2,0.5,0.5
"6802",6781,1,1,2,0.5,0.5
"6803",6782,1,1,2,0.5,0.5
"6804",6783,1,1,2,0.5,0.5
"6805",6784,1,1,2,0.5,0.5
"6806",6785,1,1,2,0.5,0.5
"6807",6786,1,1,2,0.5,0.5
"6808",6787,1,1,2,0.5,0.5
"6809",6788,1,1,2,0.5,0.5
"6810",6789,1,1,2,0.5,0.5
"6811",6790,1,1,2,0.5,0.5
"6812",6791,1,1,2,0.5,0.5
"6813",6792,1,1,2,0.5,0.5
"6814",6793,1,1,2,0.5,0.5
"6815",6794,1,1,2,0.5,0.5
"6816",6795,1,1,2,0.5,0.5
"6817",6796,1,1,2,0.5,0.5
"6818",6797,1,1,2,0.5,0.5
"6819",6798,1,1,2,0.5,0.5
"6820",6799,1,1,2,0.5,0.5
"6821",6800,1,1,2,0.5,0.5
"6822",6801,1,1,2,0.5,0.5
"6823",6802,1,1,2,0.5,0.5
"6824",6803,1,1,2,0.5,0.5
"6825",6804,1,1,2,0.5,0.5
"6826",6805,1,1,2,0.5,0.5
"6827",6806,1,1,2,0.5,0.5
"6828",6807,1,1,2,0.5,0.5
"6829",6808,1,1,2,0.5,0.5
"6830",6809,1,1,2,0.5,0.5
"6831",6810,1,1,2,0.5,0.5
"6832",6811,1,1,2,0.5,0.5
"6833",6812,1,1,2,0.5,0.5
"6834",6813,1,1,2,0.5,0.5
"6835",6814,1,1,2,0.5,0.5
"6836",6815,1,1,2,0.5,0.5
"6837",6816,1,1,2,0.5,0.5
"6838",6817,1,1,2,0.5,0.5
"6839",6818,1,1,2,0.5,0.5
"6840",6819,1,1,2,0.5,0.5
"6841",6820,1,1,2,0.5,0.5
"6842",6821,1,1,2,0.5,0.5
"6843",6822,1,1,2,0.5,0.5
"6844",6823,1,1,2,0.5,0.5
"6845",6824,1,1,2,0.5,0.5
"6846",6825,1,1,2,0.5,0.5
"6847",6826,1,1,2,0.5,0.5
"6848",6827,1,1,2,0.5,0.5
"6849",6828,1,1,2,0.5,0.5
"6850",6829,1,1,2,0.5,0.5
"6851",6830,1,1,2,0.5,0.5
"6852",6831,1,1,2,0.5,0.5
"6853",6832,1,1,2,0.5,0.5
"6854",6833,1,1,2,0.5,0.5
"6855",6834,1,1,2,0.5,0.5
"6856",6835,1,1,2,0.5,0.5
"6857",6836,1,1,2,0.5,0.5
"6858",6837,1,1,2,0.5,0.5
"6859",6838,1,1,2,0.5,0.5
"6860",6839,1,1,2,0.5,0.5
"6861",6840,1,1,2,0.5,0.5
"6862",6841,1,1,2,0.5,0.5
"6863",6842,1,1,2,0.5,0.5
"6864",6843,1,1,2,0.5,0.5
"6865",6844,1,1,2,0.5,0.5
"6866",6845,1,1,2,0.5,0.5
"6867",6846,1,1,2,0.5,0.5
"6868",6847,1,1,2,0.5,0.5
"6869",6848,1,1,2,0.5,0.5
"6870",6849,1,1,2,0.5,0.5
"6871",6850,1,1,2,0.5,0.5
"6872",6851,1,1,2,0.5,0.5
"6873",6852,1,1,2,0.5,0.5
"6874",6853,1,1,2,0.5,0.5
"6875",6854,1,1,2,0.5,0.5
"6876",6855,1,1,2,0.5,0.5
"6877",6856,1,1,2,0.5,0.5
"6878",6857,1,1,2,0.5,0.5
"6879",6858,1,1,2,0.5,0.5
"6880",6859,1,1,2,0.5,0.5
"6881",6860,1,1,2,0.5,0.5
"6882",6861,1,1,2,0.5,0.5
"6883",6862,1,1,2,0.5,0.5
"6884",6863,1,1,2,0.5,0.5
"6885",6864,1,1,2,0.5,0.5
"6886",6865,1,1,2,0.5,0.5
"6887",6866,1,1,2,0.5,0.5
"6888",6867,1,1,2,0.5,0.5
"6889",6868,1,1,2,0.5,0.5
"6890",6869,1,1,2,0.5,0.5
"6891",6870,1,1,2,0.5,0.5
"6892",6871,1,1,2,0.5,0.5
"6893",6872,1,1,2,0.5,0.5
"6894",6873,1,1,2,0.5,0.5
"6895",6874,1,1,2,0.5,0.5
"6896",6875,1,1,2,0.5,0.5
"6897",6876,1,1,2,0.5,0.5
"6898",6877,1,1,2,0.5,0.5
"6899",6878,1,1,2,0.5,0.5
"6900",6879,1,1,2,0.5,0.5
"6901",6880,1,1,2,0.5,0.5
"6902",6881,1,1,2,0.5,0.5
"6903",6882,1,1,2,0.5,0.5
"6904",6883,1,1,2,0.5,0.5
"6905",6884,1,1,2,0.5,0.5
"6906",6885,1,1,2,0.5,0.5
"6907",6886,1,1,2,0.5,0.5
"6908",6887,1,1,2,0.5,0.5
"6909",6888,1,1,2,0.5,0.5
"6910",6889,1,1,2,0.5,0.5
"6911",6890,1,1,2,0.5,0.5
"6912",6891,1,1,2,0.5,0.5
"6913",6892,1,1,2,0.5,0.5
"6914",6893,1,1,2,0.5,0.5
"6915",6894,1,1,2,0.5,0.5
"6916",6895,1,1,2,0.5,0.5
"6917",6896,1,1,2,0.5,0.5
"6918",6897,1,1,2,0.5,0.5
"6919",6898,1,1,2,0.5,0.5
"6920",6899,1,1,2,0.5,0.5
"6921",6900,1,1,2,0.5,0.5
"6922",6901,1,1,2,0.5,0.5
"6923",6902,1,1,2,0.5,0.5
"6924",6903,1,1,2,0.5,0.5
"6925",6904,1,1,2,0.5,0.5
"6926",6905,1,1,2,0.5,0.5
"6927",6906,1,1,2,0.5,0.5
"6928",6907,1,1,2,0.5,0.5
"6929",6908,1,1,2,0.5,0.5
"6930",6909,1,1,2,0.5,0.5
"6931",6910,1,1,2,0.5,0.5
"6932",6911,1,1,2,0.5,0.5
"6933",6912,1,1,2,0.5,0.5
"6934",6913,1,1,2,0.5,0.5
"6935",6914,1,1,2,0.5,0.5
"6936",6915,1,1,2,0.5,0.5
"6937",6916,1,1,2,0.5,0.5
"6938",6918,1,1,2,0.5,0.5
"6939",6919,1,1,2,0.5,0.5
"6940",6920,1,1,2,0.5,0.5
"6941",6921,1,1,2,0.5,0.5
"6942",6922,1,1,2,0.5,0.5
"6943",6923,1,1,2,0.5,0.5
"6944",6924,1,1,2,0.5,0.5
"6945",6925,1,1,2,0.5,0.5
"6946",6926,1,1,2,0.5,0.5
"6947",6927,1,1,2,0.5,0.5
"6948",6928,1,1,2,0.5,0.5
"6949",6929,1,1,2,0.5,0.5
"6950",6930,1,1,2,0.5,0.5
"6951",6931,1,1,2,0.5,0.5
"6952",6932,1,1,2,0.5,0.5
"6953",6933,1,1,2,0.5,0.5
"6954",6934,1,1,2,0.5,0.5
"6955",6935,1,1,2,0.5,0.5
"6956",6936,1,1,2,0.5,0.5
"6957",6937,1,1,2,0.5,0.5
"6958",6938,1,1,2,0.5,0.5
"6959",6939,1,1,2,0.5,0.5
"6960",6940,1,1,2,0.5,0.5
"6961",6941,1,1,2,0.5,0.5
"6962",6942,1,1,2,0.5,0.5
"6963",6943,1,1,2,0.5,0.5
"6964",6944,1,1,2,0.5,0.5
"6965",6945,1,1,2,0.5,0.5
"6966",6946,1,1,2,0.5,0.5
"6967",6947,1,1,2,0.5,0.5
"6968",6948,1,1,2,0.5,0.5
"6969",6949,1,1,2,0.5,0.5
"6970",6950,1,1,2,0.5,0.5
"6971",6952,1,1,2,0.5,0.5
"6972",6953,1,1,2,0.5,0.5
"6973",6954,1,1,2,0.5,0.5
"6974",6955,1,1,2,0.5,0.5
"6975",6956,1,1,2,0.5,0.5
"6976",6957,1,1,2,0.5,0.5
"6977",6958,1,1,2,0.5,0.5
"6978",6959,1,1,2,0.5,0.5
"6979",6960,1,1,2,0.5,0.5
"6980",6961,1,1,2,0.5,0.5
"6981",6962,1,1,2,0.5,0.5
"6982",6963,1,1,2,0.5,0.5
"6983",6964,1,1,2,0.5,0.5
"6984",6965,1,1,2,0.5,0.5
"6985",6966,1,1,2,0.5,0.5
"6986",6967,1,1,2,0.5,0.5
"6987",6968,1,1,2,0.5,0.5
"6988",6969,1,1,2,0.5,0.5
"6989",6970,1,1,2,0.5,0.5
"6990",6971,1,1,2,0.5,0.5
"6991",6972,1,1,2,0.5,0.5
"6992",6973,1,1,2,0.5,0.5
"6993",6974,1,1,2,0.5,0.5
"6994",6975,1,1,2,0.5,0.5
"6995",6976,1,1,2,0.5,0.5
"6996",6977,1,1,2,0.5,0.5
"6997",6978,1,1,2,0.5,0.5
"6998",6979,1,1,2,0.5,0.5
"6999",6980,1,1,2,0.5,0.5
"7000",6981,1,1,2,0.5,0.5
"7001",6982,1,1,2,0.5,0.5
"7002",6983,1,1,2,0.5,0.5
"7003",6984,1,1,2,0.5,0.5
"7004",6985,1,1,2,0.5,0.5
"7005",6987,1,1,2,0.5,0.5
"7006",6988,1,1,2,0.5,0.5
"7007",6989,1,1,2,0.5,0.5
"7008",6990,1,1,2,0.5,0.5
"7009",6991,1,1,2,0.5,0.5
"7010",6992,1,1,2,0.5,0.5
"7011",6993,1,1,2,0.5,0.5
"7012",6994,1,1,2,0.5,0.5
"7013",6995,1,1,2,0.5,0.5
"7014",6996,1,1,2,0.5,0.5
"7015",6997,1,1,2,0.5,0.5
"7016",6998,1,1,2,0.5,0.5
"7017",6999,1,1,2,0.5,0.5
"7018",7000,1,1,2,0.5,0.5
"7019",7001,1,1,2,0.5,0.5
"7020",7002,1,1,2,0.5,0.5
"7021",7003,1,1,2,0.5,0.5
"7022",7004,1,1,2,0.5,0.5
"7023",7005,1,1,2,0.5,0.5
"7024",7006,1,1,2,0.5,0.5
"7025",7007,1,1,2,0.5,0.5
"7026",7008,1,1,2,0.5,0.5
"7027",7009,1,1,2,0.5,0.5
"7028",7010,1,1,2,0.5,0.5
"7029",7011,1,1,2,0.5,0.5
"7030",7012,1,1,2,0.5,0.5
"7031",7013,1,1,2,0.5,0.5
"7032",7014,1,1,2,0.5,0.5
"7033",7015,1,1,2,0.5,0.5
"7034",7016,1,1,2,0.5,0.5
"7035",7017,1,1,2,0.5,0.5
"7036",7018,1,1,2,0.5,0.5
"7037",7019,1,1,2,0.5,0.5
"7038",7020,1,1,2,0.5,0.5
"7039",7021,1,1,2,0.5,0.5
"7040",7022,1,1,2,0.5,0.5
"7041",7023,1,1,2,0.5,0.5
"7042",7024,1,1,2,0.5,0.5
"7043",7025,1,1,2,0.5,0.5
"7044",7026,1,1,2,0.5,0.5
"7045",7027,1,1,2,0.5,0.5
"7046",7028,1,1,2,0.5,0.5
"7047",7029,1,1,2,0.5,0.5
"7048",7030,1,1,2,0.5,0.5
"7049",7031,1,1,2,0.5,0.5
"7050",7032,1,1,2,0.5,0.5
"7051",7033,1,1,2,0.5,0.5
"7052",7034,1,1,2,0.5,0.5
"7053",7035,1,1,2,0.5,0.5
"7054",7036,1,1,2,0.5,0.5
"7055",7037,1,1,2,0.5,0.5
"7056",7038,1,1,2,0.5,0.5
"7057",7039,1,1,2,0.5,0.5
"7058",7040,1,1,2,0.5,0.5
"7059",7041,1,1,2,0.5,0.5
"7060",7042,1,1,2,0.5,0.5
"7061",7043,1,1,2,0.5,0.5
"7062",7044,1,1,2,0.5,0.5
"7063",7045,1,1,2,0.5,0.5
"7064",7046,1,1,2,0.5,0.5
"7065",7047,1,1,2,0.5,0.5
"7066",7048,1,1,2,0.5,0.5
"7067",7049,1,1,2,0.5,0.5
"7068",7050,1,1,2,0.5,0.5
"7069",7051,1,1,2,0.5,0.5
"7070",7052,1,1,2,0.5,0.5
"7071",7053,1,1,2,0.5,0.5
"7072",7054,1,1,2,0.5,0.5
"7073",7055,1,1,2,0.5,0.5
"7074",7056,1,1,2,0.5,0.5
"7075",7057,1,1,2,0.5,0.5
"7076",7058,1,1,2,0.5,0.5
"7077",7059,1,1,2,0.5,0.5
"7078",7060,1,1,2,0.5,0.5
"7079",7061,1,1,2,0.5,0.5
"7080",7062,1,1,2,0.5,0.5
"7081",7063,1,1,2,0.5,0.5
"7082",7064,1,1,2,0.5,0.5
"7083",7065,1,1,2,0.5,0.5
"7084",7066,1,1,2,0.5,0.5
"7085",7067,1,1,2,0.5,0.5
"7086",7068,1,1,2,0.5,0.5
"7087",7069,1,1,2,0.5,0.5
"7088",7070,1,1,2,0.5,0.5
"7089",7071,1,1,2,0.5,0.5
"7090",7072,1,1,2,0.5,0.5
"7091",7073,1,1,2,0.5,0.5
"7092",7074,1,1,2,0.5,0.5
"7093",7075,1,1,2,0.5,0.5
"7094",7076,1,1,2,0.5,0.5
"7095",7077,1,1,2,0.5,0.5
"7096",7078,1,1,2,0.5,0.5
"7097",7079,1,1,2,0.5,0.5
"7098",7080,1,1,2,0.5,0.5
"7099",7081,1,1,2,0.5,0.5
"7100",7082,1,1,2,0.5,0.5
"7101",7083,1,1,2,0.5,0.5
"7102",7084,1,1,2,0.5,0.5
"7103",7085,1,1,2,0.5,0.5
"7104",7086,1,1,2,0.5,0.5
"7105",7087,1,1,2,0.5,0.5
"7106",7088,1,1,2,0.5,0.5
"7107",7089,1,1,2,0.5,0.5
"7108",7090,1,1,2,0.5,0.5
"7109",7091,1,1,2,0.5,0.5
"7110",7092,1,1,2,0.5,0.5
"7111",7093,1,1,2,0.5,0.5
"7112",7094,1,1,2,0.5,0.5
"7113",7095,1,1,2,0.5,0.5
"7114",7096,1,1,2,0.5,0.5
"7115",7097,1,1,2,0.5,0.5
"7116",7098,1,1,2,0.5,0.5
"7117",7099,1,1,2,0.5,0.5
"7118",7100,1,1,2,0.5,0.5
"7119",7101,1,1,2,0.5,0.5
"7120",7102,1,1,2,0.5,0.5
"7121",7103,1,1,2,0.5,0.5
"7122",7104,1,1,2,0.5,0.5
"7123",7105,1,1,2,0.5,0.5
"7124",7106,1,1,2,0.5,0.5
"7125",7107,1,1,2,0.5,0.5
"7126",7108,1,1,2,0.5,0.5
"7127",7109,1,1,2,0.5,0.5
"7128",7110,1,1,2,0.5,0.5
"7129",7111,1,1,2,0.5,0.5
"7130",7112,1,1,2,0.5,0.5
"7131",7113,1,1,2,0.5,0.5
"7132",7114,1,1,2,0.5,0.5
"7133",7115,1,1,2,0.5,0.5
"7134",7116,1,1,2,0.5,0.5
"7135",7118,1,1,2,0.5,0.5
"7136",7119,1,1,2,0.5,0.5
"7137",7120,1,1,2,0.5,0.5
"7138",7121,1,1,2,0.5,0.5
"7139",7122,1,1,2,0.5,0.5
"7140",7123,1,1,2,0.5,0.5
"7141",7124,1,1,2,0.5,0.5
"7142",7125,1,1,2,0.5,0.5
"7143",7126,1,1,2,0.5,0.5
"7144",7127,1,1,2,0.5,0.5
"7145",7128,1,1,2,0.5,0.5
"7146",7129,1,1,2,0.5,0.5
"7147",7130,1,1,2,0.5,0.5
"7148",7131,1,1,2,0.5,0.5
"7149",7132,1,1,2,0.5,0.5
"7150",7133,1,1,2,0.5,0.5
"7151",7134,1,1,2,0.5,0.5
"7152",7135,1,1,2,0.5,0.5
"7153",7136,1,1,2,0.5,0.5
"7154",7137,1,1,2,0.5,0.5
"7155",7138,1,1,2,0.5,0.5
"7156",7139,1,1,2,0.5,0.5
"7157",7140,1,1,2,0.5,0.5
"7158",7141,1,1,2,0.5,0.5
"7159",7142,1,1,2,0.5,0.5
"7160",7143,1,1,2,0.5,0.5
"7161",7144,1,1,2,0.5,0.5
"7162",7145,1,1,2,0.5,0.5
"7163",7146,1,1,2,0.5,0.5
"7164",7147,1,1,2,0.5,0.5
"7165",7148,1,1,2,0.5,0.5
"7166",7149,1,1,2,0.5,0.5
"7167",7150,1,1,2,0.5,0.5
"7168",7151,1,1,2,0.5,0.5
"7169",7152,1,1,2,0.5,0.5
"7170",7153,1,1,2,0.5,0.5
"7171",7154,1,1,2,0.5,0.5
"7172",7155,1,1,2,0.5,0.5
"7173",7156,1,1,2,0.5,0.5
"7174",7157,1,1,2,0.5,0.5
"7175",7158,1,1,2,0.5,0.5
"7176",7159,1,1,2,0.5,0.5
"7177",7160,1,1,2,0.5,0.5
"7178",7161,1,1,2,0.5,0.5
"7179",7162,1,1,2,0.5,0.5
"7180",7163,1,1,2,0.5,0.5
"7181",7164,1,1,2,0.5,0.5
"7182",7165,1,1,2,0.5,0.5
"7183",7166,1,1,2,0.5,0.5
"7184",7167,1,1,2,0.5,0.5
"7185",7169,1,1,2,0.5,0.5
"7186",7170,1,1,2,0.5,0.5
"7187",7171,1,1,2,0.5,0.5
"7188",7172,1,1,2,0.5,0.5
"7189",7173,1,1,2,0.5,0.5
"7190",7174,1,1,2,0.5,0.5
"7191",7175,1,1,2,0.5,0.5
"7192",7176,1,1,2,0.5,0.5
"7193",7177,1,1,2,0.5,0.5
"7194",7178,1,1,2,0.5,0.5
"7195",7179,1,1,2,0.5,0.5
"7196",7181,1,1,2,0.5,0.5
"7197",7182,1,1,2,0.5,0.5
"7198",7183,1,1,2,0.5,0.5
"7199",7184,1,1,2,0.5,0.5
"7200",7185,1,1,2,0.5,0.5
"7201",7186,1,1,2,0.5,0.5
"7202",7187,1,1,2,0.5,0.5
"7203",7188,1,1,2,0.5,0.5
"7204",7189,1,1,2,0.5,0.5
"7205",7190,1,1,2,0.5,0.5
"7206",7191,1,1,2,0.5,0.5
"7207",7192,1,1,2,0.5,0.5
"7208",7193,1,1,2,0.5,0.5
"7209",7194,1,1,2,0.5,0.5
"7210",7195,1,1,2,0.5,0.5
"7211",7196,1,1,2,0.5,0.5
"7212",7197,1,1,2,0.5,0.5
"7213",7198,1,1,2,0.5,0.5
"7214",7199,1,1,2,0.5,0.5
"7215",7200,1,1,2,0.5,0.5
"7216",7201,1,1,2,0.5,0.5
"7217",7202,1,1,2,0.5,0.5
"7218",7203,1,1,2,0.5,0.5
"7219",7204,1,1,2,0.5,0.5
"7220",7205,1,1,2,0.5,0.5
"7221",7206,1,1,2,0.5,0.5
"7222",7207,1,1,2,0.5,0.5
"7223",7208,1,1,2,0.5,0.5
"7224",7209,1,1,2,0.5,0.5
"7225",7210,1,1,2,0.5,0.5
"7226",7211,1,1,2,0.5,0.5
"7227",7212,1,1,2,0.5,0.5
"7228",7213,1,1,2,0.5,0.5
"7229",7214,1,1,2,0.5,0.5
"7230",7215,1,1,2,0.5,0.5
"7231",7216,1,1,2,0.5,0.5
"7232",7217,1,1,2,0.5,0.5
"7233",7218,1,1,2,0.5,0.5
"7234",7219,1,1,2,0.5,0.5
"7235",7220,1,1,2,0.5,0.5
"7236",7221,1,1,2,0.5,0.5
"7237",7222,1,1,2,0.5,0.5
"7238",7223,1,1,2,0.5,0.5
"7239",7224,1,1,2,0.5,0.5
"7240",7225,1,1,2,0.5,0.5
"7241",7226,1,1,2,0.5,0.5
"7242",7227,1,1,2,0.5,0.5
"7243",7228,1,1,2,0.5,0.5
"7244",7229,1,1,2,0.5,0.5
"7245",7230,1,1,2,0.5,0.5
"7246",7231,1,1,2,0.5,0.5
"7247",7232,1,1,2,0.5,0.5
"7248",7233,1,1,2,0.5,0.5
"7249",7234,1,1,2,0.5,0.5
"7250",7235,1,1,2,0.5,0.5
"7251",7236,1,1,2,0.5,0.5
"7252",7237,1,1,2,0.5,0.5
"7253",7238,1,1,2,0.5,0.5
"7254",7239,1,1,2,0.5,0.5
"7255",7240,1,1,2,0.5,0.5
"7256",7241,1,1,2,0.5,0.5
"7257",7242,1,1,2,0.5,0.5
"7258",7243,1,1,2,0.5,0.5
"7259",7244,1,1,2,0.5,0.5
"7260",7245,1,1,2,0.5,0.5
"7261",7246,1,1,2,0.5,0.5
"7262",7247,1,1,2,0.5,0.5
"7263",7248,1,1,2,0.5,0.5
"7264",7249,1,1,2,0.5,0.5
"7265",7250,1,1,2,0.5,0.5
"7266",7251,1,1,2,0.5,0.5
"7267",7252,1,1,2,0.5,0.5
"7268",7253,1,1,2,0.5,0.5
"7269",7254,1,1,2,0.5,0.5
"7270",7255,1,1,2,0.5,0.5
"7271",7256,1,1,2,0.5,0.5
"7272",7257,1,1,2,0.5,0.5
"7273",7258,1,1,2,0.5,0.5
"7274",7259,1,1,2,0.5,0.5
"7275",7260,1,1,2,0.5,0.5
"7276",7261,1,1,2,0.5,0.5
"7277",7262,1,1,2,0.5,0.5
"7278",7263,1,1,2,0.5,0.5
"7279",7264,1,1,2,0.5,0.5
"7280",7265,1,1,2,0.5,0.5
"7281",7266,1,1,2,0.5,0.5
"7282",7267,1,1,2,0.5,0.5
"7283",7268,1,1,2,0.5,0.5
"7284",7269,1,1,2,0.5,0.5
"7285",7270,1,1,2,0.5,0.5
"7286",7271,1,1,2,0.5,0.5
"7287",7272,1,1,2,0.5,0.5
"7288",7273,1,1,2,0.5,0.5
"7289",7274,1,1,2,0.5,0.5
"7290",7275,1,1,2,0.5,0.5
"7291",7276,1,1,2,0.5,0.5
"7292",7277,1,1,2,0.5,0.5
"7293",7278,1,1,2,0.5,0.5
"7294",7279,1,1,2,0.5,0.5
"7295",7280,1,1,2,0.5,0.5
"7296",7281,1,1,2,0.5,0.5
"7297",7282,1,1,2,0.5,0.5
"7298",7283,1,1,2,0.5,0.5
"7299",7284,1,1,2,0.5,0.5
"7300",7285,1,1,2,0.5,0.5
"7301",7286,1,1,2,0.5,0.5
"7302",7287,1,1,2,0.5,0.5
"7303",7288,1,1,2,0.5,0.5
"7304",7289,1,1,2,0.5,0.5
"7305",7290,1,1,2,0.5,0.5
"7306",7291,1,1,2,0.5,0.5
"7307",7292,1,1,2,0.5,0.5
"7308",7293,1,1,2,0.5,0.5
"7309",7294,1,1,2,0.5,0.5
"7310",7295,1,1,2,0.5,0.5
"7311",7296,1,1,2,0.5,0.5
"7312",7297,1,1,2,0.5,0.5
"7313",7298,1,1,2,0.5,0.5
"7314",7299,1,1,2,0.5,0.5
"7315",7300,1,1,2,0.5,0.5
"7316",7302,1,1,2,0.5,0.5
"7317",7303,1,1,2,0.5,0.5
"7318",7304,1,1,2,0.5,0.5
"7319",7305,1,1,2,0.5,0.5
"7320",7306,1,1,2,0.5,0.5
"7321",7307,1,1,2,0.5,0.5
"7322",7308,1,1,2,0.5,0.5
"7323",7309,1,1,2,0.5,0.5
"7324",7310,1,1,2,0.5,0.5
"7325",7311,1,1,2,0.5,0.5
"7326",7312,1,1,2,0.5,0.5
"7327",7313,1,1,2,0.5,0.5
"7328",7314,1,1,2,0.5,0.5
"7329",7315,1,1,2,0.5,0.5
"7330",7316,1,1,2,0.5,0.5
"7331",7317,1,1,2,0.5,0.5
"7332",7318,1,1,2,0.5,0.5
"7333",7319,1,1,2,0.5,0.5
"7334",7320,1,1,2,0.5,0.5
"7335",7321,1,1,2,0.5,0.5
"7336",7322,1,1,2,0.5,0.5
"7337",7323,1,1,2,0.5,0.5
"7338",7324,1,1,2,0.5,0.5
"7339",7325,1,1,2,0.5,0.5
"7340",7326,1,1,2,0.5,0.5
"7341",7327,1,1,2,0.5,0.5
"7342",7328,1,1,2,0.5,0.5
"7343",7329,1,1,2,0.5,0.5
"7344",7330,1,1,2,0.5,0.5
"7345",7331,1,1,2,0.5,0.5
"7346",7332,1,1,2,0.5,0.5
"7347",7333,1,1,2,0.5,0.5
"7348",7334,1,1,2,0.5,0.5
"7349",7335,1,1,2,0.5,0.5
"7350",7336,1,1,2,0.5,0.5
"7351",7337,1,1,2,0.5,0.5
"7352",7338,1,1,2,0.5,0.5
"7353",7339,1,1,2,0.5,0.5
"7354",7340,1,1,2,0.5,0.5
"7355",7341,1,1,2,0.5,0.5
"7356",7342,1,1,2,0.5,0.5
"7357",7343,1,1,2,0.5,0.5
"7358",7344,1,1,2,0.5,0.5
"7359",7345,1,1,2,0.5,0.5
"7360",7346,1,1,2,0.5,0.5
"7361",7347,1,1,2,0.5,0.5
"7362",7348,1,1,2,0.5,0.5
"7363",7349,1,1,2,0.5,0.5
"7364",7350,1,1,2,0.5,0.5
"7365",7351,1,1,2,0.5,0.5
"7366",7352,1,1,2,0.5,0.5
"7367",7353,1,1,2,0.5,0.5
"7368",7354,1,1,2,0.5,0.5
"7369",7355,1,1,2,0.5,0.5
"7370",7356,1,1,2,0.5,0.5
"7371",7357,1,1,2,0.5,0.5
"7372",7358,1,1,2,0.5,0.5
"7373",7359,1,1,2,0.5,0.5
"7374",7360,1,1,2,0.5,0.5
"7375",7361,1,1,2,0.5,0.5
"7376",7362,1,1,2,0.5,0.5
"7377",7363,1,1,2,0.5,0.5
"7378",7364,1,1,2,0.5,0.5
"7379",7365,1,1,2,0.5,0.5
"7380",7366,1,1,2,0.5,0.5
"7381",7367,1,1,2,0.5,0.5
"7382",7368,1,1,2,0.5,0.5
"7383",7369,1,1,2,0.5,0.5
"7384",7370,1,1,2,0.5,0.5
"7385",7371,1,1,2,0.5,0.5
"7386",7372,1,1,2,0.5,0.5
"7387",7373,1,1,2,0.5,0.5
"7388",7374,1,1,2,0.5,0.5
"7389",7375,1,1,2,0.5,0.5
"7390",7376,1,1,2,0.5,0.5
"7391",7377,1,1,2,0.5,0.5
"7392",7379,1,1,2,0.5,0.5
"7393",7380,1,1,2,0.5,0.5
"7394",7381,1,1,2,0.5,0.5
"7395",7382,1,1,2,0.5,0.5
"7396",7383,1,1,2,0.5,0.5
"7397",7384,1,1,2,0.5,0.5
"7398",7385,1,1,2,0.5,0.5
"7399",7386,1,1,2,0.5,0.5
"7400",7387,1,1,2,0.5,0.5
"7401",7388,1,1,2,0.5,0.5
"7402",7389,1,1,2,0.5,0.5
"7403",7390,1,1,2,0.5,0.5
"7404",7391,1,1,2,0.5,0.5
"7405",7392,1,1,2,0.5,0.5
"7406",7393,1,1,2,0.5,0.5
"7407",7394,1,1,2,0.5,0.5
"7408",7395,1,1,2,0.5,0.5
"7409",7396,1,1,2,0.5,0.5
"7410",7397,1,1,2,0.5,0.5
"7411",7398,1,1,2,0.5,0.5
"7412",7399,1,1,2,0.5,0.5
"7413",7400,1,1,2,0.5,0.5
"7414",7401,1,1,2,0.5,0.5
"7415",7402,1,1,2,0.5,0.5
"7416",7403,1,1,2,0.5,0.5
"7417",7404,1,1,2,0.5,0.5
"7418",7405,1,1,2,0.5,0.5
"7419",7406,1,1,2,0.5,0.5
"7420",7407,1,1,2,0.5,0.5
"7421",7408,1,1,2,0.5,0.5
"7422",7409,1,1,2,0.5,0.5
"7423",7410,1,1,2,0.5,0.5
"7424",7411,1,1,2,0.5,0.5
"7425",7412,1,1,2,0.5,0.5
"7426",7413,1,1,2,0.5,0.5
"7427",7414,1,1,2,0.5,0.5
"7428",7415,1,1,2,0.5,0.5
"7429",7416,1,1,2,0.5,0.5
"7430",7417,1,1,2,0.5,0.5
"7431",7418,1,1,2,0.5,0.5
"7432",7419,1,1,2,0.5,0.5
"7433",7420,1,1,2,0.5,0.5
"7434",7421,1,1,2,0.5,0.5
"7435",7422,1,1,2,0.5,0.5
"7436",7423,1,1,2,0.5,0.5
"7437",7424,1,1,2,0.5,0.5
"7438",7425,1,1,2,0.5,0.5
"7439",7426,1,1,2,0.5,0.5
"7440",7427,1,1,2,0.5,0.5
"7441",7428,1,1,2,0.5,0.5
"7442",7429,1,1,2,0.5,0.5
"7443",7430,1,1,2,0.5,0.5
"7444",7431,1,1,2,0.5,0.5
"7445",7432,1,1,2,0.5,0.5
"7446",7433,1,1,2,0.5,0.5
"7447",7434,1,1,2,0.5,0.5
"7448",7435,1,1,2,0.5,0.5
"7449",7436,1,1,2,0.5,0.5
"7450",7437,1,1,2,0.5,0.5
"7451",7438,1,1,2,0.5,0.5
"7452",7439,1,1,2,0.5,0.5
"7453",7440,1,1,2,0.5,0.5
"7454",7441,1,1,2,0.5,0.5
"7455",7442,1,1,2,0.5,0.5
"7456",7443,1,1,2,0.5,0.5
"7457",7444,1,1,2,0.5,0.5
"7458",7445,1,1,2,0.5,0.5
"7459",7446,1,1,2,0.5,0.5
"7460",7447,1,1,2,0.5,0.5
"7461",7448,1,1,2,0.5,0.5
"7462",7449,1,1,2,0.5,0.5
"7463",7450,1,1,2,0.5,0.5
"7464",7451,1,1,2,0.5,0.5
"7465",7452,1,1,2,0.5,0.5
"7466",7453,1,1,2,0.5,0.5
"7467",7454,1,1,2,0.5,0.5
"7468",7455,1,1,2,0.5,0.5
"7469",7456,1,1,2,0.5,0.5
"7470",7457,1,1,2,0.5,0.5
"7471",7458,1,1,2,0.5,0.5
"7472",7459,1,1,2,0.5,0.5
"7473",7460,1,1,2,0.5,0.5
"7474",7461,1,1,2,0.5,0.5
"7475",7462,1,1,2,0.5,0.5
"7476",7463,1,1,2,0.5,0.5
"7477",7464,1,1,2,0.5,0.5
"7478",7465,1,1,2,0.5,0.5
"7479",7466,1,1,2,0.5,0.5
"7480",7467,1,1,2,0.5,0.5
"7481",7468,1,1,2,0.5,0.5
"7482",7469,1,1,2,0.5,0.5
"7483",7470,1,1,2,0.5,0.5
"7484",7471,1,1,2,0.5,0.5
"7485",7472,1,1,2,0.5,0.5
"7486",7473,1,1,2,0.5,0.5
"7487",7474,1,1,2,0.5,0.5
"7488",7475,1,1,2,0.5,0.5
"7489",7476,1,1,2,0.5,0.5
"7490",7477,1,1,2,0.5,0.5
"7491",7478,1,1,2,0.5,0.5
"7492",7479,1,1,2,0.5,0.5
"7493",7480,1,1,2,0.5,0.5
"7494",7481,1,1,2,0.5,0.5
"7495",7482,1,1,2,0.5,0.5
"7496",7483,1,1,2,0.5,0.5
"7497",7484,1,1,2,0.5,0.5
"7498",7485,1,1,2,0.5,0.5
"7499",7486,1,1,2,0.5,0.5
"7500",7487,1,1,2,0.5,0.5
"7501",7488,1,1,2,0.5,0.5
"7502",7489,1,1,2,0.5,0.5
"7503",7490,1,1,2,0.5,0.5
"7504",7491,1,1,2,0.5,0.5
"7505",7492,1,1,2,0.5,0.5
"7506",7493,1,1,2,0.5,0.5
"7507",7494,1,1,2,0.5,0.5
"7508",7495,1,1,2,0.5,0.5
"7509",7496,1,1,2,0.5,0.5
"7510",7497,1,1,2,0.5,0.5
"7511",7498,1,1,2,0.5,0.5
"7512",7499,1,1,2,0.5,0.5
"7513",7500,1,1,2,0.5,0.5
"7514",7501,1,1,2,0.5,0.5
"7515",7502,1,1,2,0.5,0.5
"7516",7503,1,1,2,0.5,0.5
"7517",7504,1,1,2,0.5,0.5
"7518",7505,1,1,2,0.5,0.5
"7519",7506,1,1,2,0.5,0.5
"7520",7507,1,1,2,0.5,0.5
"7521",7508,1,1,2,0.5,0.5
"7522",7509,1,1,2,0.5,0.5
"7523",7510,1,1,2,0.5,0.5
"7524",7511,1,1,2,0.5,0.5
"7525",7512,1,1,2,0.5,0.5
"7526",7513,1,1,2,0.5,0.5
"7527",7514,1,1,2,0.5,0.5
"7528",7515,1,1,2,0.5,0.5
"7529",7516,1,1,2,0.5,0.5
"7530",7517,1,1,2,0.5,0.5
"7531",7518,1,1,2,0.5,0.5
"7532",7519,1,1,2,0.5,0.5
"7533",7520,1,1,2,0.5,0.5
"7534",7521,1,1,2,0.5,0.5
"7535",7522,1,1,2,0.5,0.5
"7536",7523,1,1,2,0.5,0.5
"7537",7524,1,1,2,0.5,0.5
"7538",7525,1,1,2,0.5,0.5
"7539",7526,1,1,2,0.5,0.5
"7540",7527,1,1,2,0.5,0.5
"7541",7528,1,1,2,0.5,0.5
"7542",7529,1,1,2,0.5,0.5
"7543",7530,1,1,2,0.5,0.5
"7544",7531,1,1,2,0.5,0.5
"7545",7532,1,1,2,0.5,0.5
"7546",7533,1,1,2,0.5,0.5
"7547",7534,1,1,2,0.5,0.5
"7548",7535,1,1,2,0.5,0.5
"7549",7536,1,1,2,0.5,0.5
"7550",7537,1,1,2,0.5,0.5
"7551",7538,1,1,2,0.5,0.5
"7552",7539,1,1,2,0.5,0.5
"7553",7540,1,1,2,0.5,0.5
"7554",7541,1,1,2,0.5,0.5
"7555",7542,1,1,2,0.5,0.5
"7556",7543,1,1,2,0.5,0.5
"7557",7544,1,1,2,0.5,0.5
"7558",7545,1,1,2,0.5,0.5
"7559",7546,1,1,2,0.5,0.5
"7560",7547,1,1,2,0.5,0.5
"7561",7548,1,1,2,0.5,0.5
"7562",7549,1,1,2,0.5,0.5
"7563",7550,1,1,2,0.5,0.5
"7564",7551,1,1,2,0.5,0.5
"7565",7552,1,1,2,0.5,0.5
"7566",7553,1,1,2,0.5,0.5
"7567",7554,1,1,2,0.5,0.5
"7568",7555,1,1,2,0.5,0.5
"7569",7556,1,1,2,0.5,0.5
"7570",7557,1,1,2,0.5,0.5
"7571",7558,1,1,2,0.5,0.5
"7572",7559,1,1,2,0.5,0.5
"7573",7560,1,1,2,0.5,0.5
"7574",7561,1,1,2,0.5,0.5
"7575",7562,1,1,2,0.5,0.5
"7576",7563,1,1,2,0.5,0.5
"7577",7564,1,1,2,0.5,0.5
"7578",7565,1,1,2,0.5,0.5
"7579",7566,1,1,2,0.5,0.5
"7580",7567,1,1,2,0.5,0.5
"7581",7568,1,1,2,0.5,0.5
"7582",7569,1,1,2,0.5,0.5
"7583",7570,1,1,2,0.5,0.5
"7584",7571,1,1,2,0.5,0.5
"7585",7572,1,1,2,0.5,0.5
"7586",7573,1,1,2,0.5,0.5
"7587",7574,1,1,2,0.5,0.5
"7588",7575,1,1,2,0.5,0.5
"7589",7576,1,1,2,0.5,0.5
"7590",7577,1,1,2,0.5,0.5
"7591",7578,1,1,2,0.5,0.5
"7592",7579,1,1,2,0.5,0.5
"7593",7580,1,1,2,0.5,0.5
"7594",7581,1,1,2,0.5,0.5
"7595",7582,1,1,2,0.5,0.5
"7596",7583,1,1,2,0.5,0.5
"7597",7584,1,1,2,0.5,0.5
"7598",7585,1,1,2,0.5,0.5
"7599",7586,1,1,2,0.5,0.5
"7600",7587,1,1,2,0.5,0.5
"7601",7588,1,1,2,0.5,0.5
"7602",7589,1,1,2,0.5,0.5
"7603",7590,1,1,2,0.5,0.5
"7604",7591,1,1,2,0.5,0.5
"7605",7592,1,1,2,0.5,0.5
"7606",7593,1,1,2,0.5,0.5
"7607",7594,1,1,2,0.5,0.5
"7608",7595,1,1,2,0.5,0.5
"7609",7596,1,1,2,0.5,0.5
"7610",7597,1,1,2,0.5,0.5
"7611",7598,1,1,2,0.5,0.5
"7612",7599,1,1,2,0.5,0.5
"7613",7600,1,1,2,0.5,0.5
"7614",7601,1,1,2,0.5,0.5
"7615",7602,1,1,2,0.5,0.5
"7616",7603,1,1,2,0.5,0.5
"7617",7605,1,1,2,0.5,0.5
"7618",7606,1,1,2,0.5,0.5
"7619",7607,1,1,2,0.5,0.5
"7620",7608,1,1,2,0.5,0.5
"7621",7609,1,1,2,0.5,0.5
"7622",7610,1,1,2,0.5,0.5
"7623",7611,1,1,2,0.5,0.5
"7624",7612,1,1,2,0.5,0.5
"7625",7613,1,1,2,0.5,0.5
"7626",7614,1,1,2,0.5,0.5
"7627",7615,1,1,2,0.5,0.5
"7628",7616,1,1,2,0.5,0.5
"7629",7617,1,1,2,0.5,0.5
"7630",7618,1,1,2,0.5,0.5
"7631",7619,1,1,2,0.5,0.5
"7632",7620,1,1,2,0.5,0.5
"7633",7621,1,1,2,0.5,0.5
"7634",7622,1,1,2,0.5,0.5
"7635",7623,1,1,2,0.5,0.5
"7636",7624,1,1,2,0.5,0.5
"7637",7625,1,1,2,0.5,0.5
"7638",7626,1,1,2,0.5,0.5
"7639",7627,1,1,2,0.5,0.5
"7640",7628,1,1,2,0.5,0.5
"7641",7629,1,1,2,0.5,0.5
"7642",7630,1,1,2,0.5,0.5
"7643",7631,1,1,2,0.5,0.5
"7644",7632,1,1,2,0.5,0.5
"7645",7633,1,1,2,0.5,0.5
"7646",7634,1,1,2,0.5,0.5
"7647",7635,1,1,2,0.5,0.5
"7648",7636,1,1,2,0.5,0.5
"7649",7637,1,1,2,0.5,0.5
"7650",7638,1,1,2,0.5,0.5
"7651",7639,1,1,2,0.5,0.5
"7652",7640,1,1,2,0.5,0.5
"7653",7641,1,1,2,0.5,0.5
"7654",7642,1,1,2,0.5,0.5
"7655",7643,1,1,2,0.5,0.5
"7656",7644,1,1,2,0.5,0.5
"7657",7645,1,1,2,0.5,0.5
"7658",7646,1,1,2,0.5,0.5
"7659",7647,1,1,2,0.5,0.5
"7660",7649,1,1,2,0.5,0.5
"7661",7650,1,1,2,0.5,0.5
"7662",7651,1,1,2,0.5,0.5
"7663",7652,1,1,2,0.5,0.5
"7664",7653,1,1,2,0.5,0.5
"7665",7654,1,1,2,0.5,0.5
"7666",7655,1,1,2,0.5,0.5
"7667",7656,1,1,2,0.5,0.5
"7668",7657,1,1,2,0.5,0.5
"7669",7658,1,1,2,0.5,0.5
"7670",7659,1,1,2,0.5,0.5
"7671",7660,1,1,2,0.5,0.5
"7672",7661,1,1,2,0.5,0.5
"7673",7662,1,1,2,0.5,0.5
"7674",7663,1,1,2,0.5,0.5
"7675",7664,1,1,2,0.5,0.5
"7676",7665,1,1,2,0.5,0.5
"7677",7666,1,1,2,0.5,0.5
"7678",7667,1,1,2,0.5,0.5
"7679",7668,1,1,2,0.5,0.5
"7680",7669,1,1,2,0.5,0.5
"7681",7670,1,1,2,0.5,0.5
"7682",7671,1,1,2,0.5,0.5
"7683",7672,1,1,2,0.5,0.5
"7684",7673,1,1,2,0.5,0.5
"7685",7674,1,1,2,0.5,0.5
"7686",7675,1,1,2,0.5,0.5
"7687",7676,1,1,2,0.5,0.5
"7688",7677,1,1,2,0.5,0.5
"7689",7678,1,1,2,0.5,0.5
"7690",7679,1,1,2,0.5,0.5
"7691",7680,1,1,2,0.5,0.5
"7692",7681,1,1,2,0.5,0.5
"7693",7682,1,1,2,0.5,0.5
"7694",7683,1,1,2,0.5,0.5
"7695",7684,1,1,2,0.5,0.5
"7696",7685,1,1,2,0.5,0.5
"7697",7686,1,1,2,0.5,0.5
"7698",7687,1,1,2,0.5,0.5
"7699",7688,1,1,2,0.5,0.5
"7700",7689,1,1,2,0.5,0.5
"7701",7690,1,1,2,0.5,0.5
"7702",7691,1,1,2,0.5,0.5
"7703",7692,1,1,2,0.5,0.5
"7704",7693,1,1,2,0.5,0.5
"7705",7694,1,1,2,0.5,0.5
"7706",7695,1,1,2,0.5,0.5
"7707",7696,1,1,2,0.5,0.5
"7708",7697,1,1,2,0.5,0.5
"7709",7698,1,1,2,0.5,0.5
"7710",7699,1,1,2,0.5,0.5
"7711",7700,1,1,2,0.5,0.5
"7712",7701,1,1,2,0.5,0.5
"7713",7702,1,1,2,0.5,0.5
"7714",7703,1,1,2,0.5,0.5
"7715",7704,1,1,2,0.5,0.5
"7716",7705,1,1,2,0.5,0.5
"7717",7706,1,1,2,0.5,0.5
"7718",7707,1,1,2,0.5,0.5
"7719",7708,1,1,2,0.5,0.5
"7720",7709,1,1,2,0.5,0.5
"7721",7710,1,1,2,0.5,0.5
"7722",7711,1,1,2,0.5,0.5
"7723",7712,1,1,2,0.5,0.5
"7724",7713,1,1,2,0.5,0.5
"7725",7714,1,1,2,0.5,0.5
"7726",7715,1,1,2,0.5,0.5
"7727",7716,1,1,2,0.5,0.5
"7728",7717,1,1,2,0.5,0.5
"7729",7718,1,1,2,0.5,0.5
"7730",7719,1,1,2,0.5,0.5
"7731",7720,1,1,2,0.5,0.5
"7732",7721,1,1,2,0.5,0.5
"7733",7722,1,1,2,0.5,0.5
"7734",7723,1,1,2,0.5,0.5
"7735",7724,1,1,2,0.5,0.5
"7736",7725,1,1,2,0.5,0.5
"7737",7726,1,1,2,0.5,0.5
"7738",7727,1,1,2,0.5,0.5
"7739",7728,1,1,2,0.5,0.5
"7740",7729,1,1,2,0.5,0.5
"7741",7730,1,1,2,0.5,0.5
"7742",7731,1,1,2,0.5,0.5
"7743",7732,1,1,2,0.5,0.5
"7744",7733,1,1,2,0.5,0.5
"7745",7734,1,1,2,0.5,0.5
"7746",7735,1,1,2,0.5,0.5
"7747",7736,1,1,2,0.5,0.5
"7748",7737,1,1,2,0.5,0.5
"7749",7738,1,1,2,0.5,0.5
"7750",7739,1,1,2,0.5,0.5
"7751",7740,1,1,2,0.5,0.5
"7752",7741,1,1,2,0.5,0.5
"7753",7743,1,1,2,0.5,0.5
"7754",7744,1,1,2,0.5,0.5
"7755",7745,1,1,2,0.5,0.5
"7756",7746,1,1,2,0.5,0.5
"7757",7747,1,1,2,0.5,0.5
"7758",7748,1,1,2,0.5,0.5
"7759",7749,1,1,2,0.5,0.5
"7760",7750,1,1,2,0.5,0.5
"7761",7751,1,1,2,0.5,0.5
"7762",7752,1,1,2,0.5,0.5
"7763",7753,1,1,2,0.5,0.5
"7764",7754,1,1,2,0.5,0.5
"7765",7755,1,1,2,0.5,0.5
"7766",7756,1,1,2,0.5,0.5
"7767",7757,1,1,2,0.5,0.5
"7768",7758,1,1,2,0.5,0.5
"7769",7759,1,1,2,0.5,0.5
"7770",7760,1,1,2,0.5,0.5
"7771",7761,1,1,2,0.5,0.5
"7772",7762,1,1,2,0.5,0.5
"7773",7763,1,1,2,0.5,0.5
"7774",7764,1,1,2,0.5,0.5
"7775",7765,1,1,2,0.5,0.5
"7776",7766,1,1,2,0.5,0.5
"7777",7767,1,1,2,0.5,0.5
"7778",7768,1,1,2,0.5,0.5
"7779",7769,1,1,2,0.5,0.5
"7780",7770,1,1,2,0.5,0.5
"7781",7771,1,1,2,0.5,0.5
"7782",7772,1,1,2,0.5,0.5
"7783",7773,1,1,2,0.5,0.5
"7784",7774,1,1,2,0.5,0.5
"7785",7775,1,1,2,0.5,0.5
"7786",7776,1,1,2,0.5,0.5
"7787",7777,1,1,2,0.5,0.5
"7788",7778,1,1,2,0.5,0.5
"7789",7779,1,1,2,0.5,0.5
"7790",7780,1,1,2,0.5,0.5
"7791",7781,1,1,2,0.5,0.5
"7792",7782,1,1,2,0.5,0.5
"7793",7783,1,1,2,0.5,0.5
"7794",7784,1,1,2,0.5,0.5
"7795",7785,1,1,2,0.5,0.5
"7796",7786,1,1,2,0.5,0.5
"7797",7787,1,1,2,0.5,0.5
"7798",7788,1,1,2,0.5,0.5
"7799",7789,1,1,2,0.5,0.5
"7800",7790,1,1,2,0.5,0.5
"7801",7791,1,1,2,0.5,0.5
"7802",7792,1,1,2,0.5,0.5
"7803",7793,1,1,2,0.5,0.5
"7804",7794,1,1,2,0.5,0.5
"7805",7795,1,1,2,0.5,0.5
"7806",7796,1,1,2,0.5,0.5
"7807",7797,1,1,2,0.5,0.5
"7808",7798,1,1,2,0.5,0.5
"7809",7799,1,1,2,0.5,0.5
"7810",7800,1,1,2,0.5,0.5
"7811",7801,1,1,2,0.5,0.5
"7812",7802,1,1,2,0.5,0.5
"7813",7803,1,1,2,0.5,0.5
"7814",7804,1,1,2,0.5,0.5
"7815",7805,1,1,2,0.5,0.5
"7816",7806,1,1,2,0.5,0.5
"7817",7807,1,1,2,0.5,0.5
"7818",7808,1,1,2,0.5,0.5
"7819",7809,1,1,2,0.5,0.5
"7820",7810,1,1,2,0.5,0.5
"7821",7811,1,1,2,0.5,0.5
"7822",7812,1,1,2,0.5,0.5
"7823",7813,1,1,2,0.5,0.5
"7824",7814,1,1,2,0.5,0.5
"7825",7815,1,1,2,0.5,0.5
"7826",7816,1,1,2,0.5,0.5
"7827",7817,1,1,2,0.5,0.5
"7828",7818,1,1,2,0.5,0.5
"7829",7819,1,1,2,0.5,0.5
"7830",7820,1,1,2,0.5,0.5
"7831",7821,1,1,2,0.5,0.5
"7832",7822,1,1,2,0.5,0.5
"7833",7823,1,1,2,0.5,0.5
"7834",7824,1,1,2,0.5,0.5
"7835",7826,1,1,2,0.5,0.5
"7836",7827,1,1,2,0.5,0.5
"7837",7828,1,1,2,0.5,0.5
"7838",7829,1,1,2,0.5,0.5
"7839",7830,1,1,2,0.5,0.5
"7840",7831,1,1,2,0.5,0.5
"7841",7832,1,1,2,0.5,0.5
"7842",7834,1,1,2,0.5,0.5
"7843",7835,1,1,2,0.5,0.5
"7844",7836,1,1,2,0.5,0.5
"7845",7837,1,1,2,0.5,0.5
"7846",7838,1,1,2,0.5,0.5
"7847",7839,1,1,2,0.5,0.5
"7848",7840,1,1,2,0.5,0.5
"7849",7841,1,1,2,0.5,0.5
"7850",7842,1,1,2,0.5,0.5
"7851",7843,1,1,2,0.5,0.5
"7852",7844,1,1,2,0.5,0.5
"7853",7845,1,1,2,0.5,0.5
"7854",7846,1,1,2,0.5,0.5
"7855",7847,1,1,2,0.5,0.5
"7856",7848,1,1,2,0.5,0.5
"7857",7849,1,1,2,0.5,0.5
"7858",7850,1,1,2,0.5,0.5
"7859",7851,1,1,2,0.5,0.5
"7860",7852,1,1,2,0.5,0.5
"7861",7853,1,1,2,0.5,0.5
"7862",7854,1,1,2,0.5,0.5
"7863",7855,1,1,2,0.5,0.5
"7864",7856,1,1,2,0.5,0.5
"7865",7857,1,1,2,0.5,0.5
"7866",7858,1,1,2,0.5,0.5
"7867",7859,1,1,2,0.5,0.5
"7868",7860,1,1,2,0.5,0.5
"7869",7861,1,1,2,0.5,0.5
"7870",7862,1,1,2,0.5,0.5
"7871",7863,1,1,2,0.5,0.5
"7872",7864,1,1,2,0.5,0.5
"7873",7865,1,1,2,0.5,0.5
"7874",7866,1,1,2,0.5,0.5
"7875",7867,1,1,2,0.5,0.5
"7876",7868,1,1,2,0.5,0.5
"7877",7869,1,1,2,0.5,0.5
"7878",7870,1,1,2,0.5,0.5
"7879",7871,1,1,2,0.5,0.5
"7880",7872,1,1,2,0.5,0.5
"7881",7873,1,1,2,0.5,0.5
"7882",7874,1,1,2,0.5,0.5
"7883",7875,1,1,2,0.5,0.5
"7884",7876,1,1,2,0.5,0.5
"7885",7877,1,1,2,0.5,0.5
"7886",7878,1,1,2,0.5,0.5
"7887",7879,1,1,2,0.5,0.5
"7888",7880,1,1,2,0.5,0.5
"7889",7881,1,1,2,0.5,0.5
"7890",7882,1,1,2,0.5,0.5
"7891",7883,1,1,2,0.5,0.5
"7892",7884,1,1,2,0.5,0.5
"7893",7885,1,1,2,0.5,0.5
"7894",7886,1,1,2,0.5,0.5
"7895",7887,1,1,2,0.5,0.5
"7896",7888,1,1,2,0.5,0.5
"7897",7889,1,1,2,0.5,0.5
"7898",7890,1,1,2,0.5,0.5
"7899",7891,1,1,2,0.5,0.5
"7900",7892,1,1,2,0.5,0.5
"7901",7893,1,1,2,0.5,0.5
"7902",7894,1,1,2,0.5,0.5
"7903",7895,1,1,2,0.5,0.5
"7904",7896,1,1,2,0.5,0.5
"7905",7897,1,1,2,0.5,0.5
"7906",7898,1,1,2,0.5,0.5
"7907",7899,1,1,2,0.5,0.5
"7908",7900,1,1,2,0.5,0.5
"7909",7901,1,1,2,0.5,0.5
"7910",7902,1,1,2,0.5,0.5
"7911",7903,1,1,2,0.5,0.5
"7912",7904,1,1,2,0.5,0.5
"7913",7905,1,1,2,0.5,0.5
"7914",7906,1,1,2,0.5,0.5
"7915",7907,1,1,2,0.5,0.5
"7916",7908,1,1,2,0.5,0.5
"7917",7909,1,1,2,0.5,0.5
"7918",7910,1,1,2,0.5,0.5
"7919",7911,1,1,2,0.5,0.5
"7920",7912,1,1,2,0.5,0.5
"7921",7913,1,1,2,0.5,0.5
"7922",7914,1,1,2,0.5,0.5
"7923",7915,1,1,2,0.5,0.5
"7924",7916,1,1,2,0.5,0.5
"7925",7917,1,1,2,0.5,0.5
"7926",7918,1,1,2,0.5,0.5
"7927",7919,1,1,2,0.5,0.5
"7928",7920,1,1,2,0.5,0.5
"7929",7921,1,1,2,0.5,0.5
"7930",7922,1,1,2,0.5,0.5
"7931",7923,1,1,2,0.5,0.5
"7932",7924,1,1,2,0.5,0.5
"7933",7925,1,1,2,0.5,0.5
"7934",7926,1,1,2,0.5,0.5
"7935",7927,1,1,2,0.5,0.5
"7936",7928,1,1,2,0.5,0.5
"7937",7929,1,1,2,0.5,0.5
"7938",7930,1,1,2,0.5,0.5
"7939",7931,1,1,2,0.5,0.5
"7940",7932,1,1,2,0.5,0.5
"7941",7933,1,1,2,0.5,0.5
"7942",7934,1,1,2,0.5,0.5
"7943",7935,1,1,2,0.5,0.5
"7944",7936,1,1,2,0.5,0.5
"7945",7937,1,1,2,0.5,0.5
"7946",7938,1,1,2,0.5,0.5
"7947",7939,1,1,2,0.5,0.5
"7948",7940,1,1,2,0.5,0.5
"7949",7941,1,1,2,0.5,0.5
"7950",7942,1,1,2,0.5,0.5
"7951",7943,1,1,2,0.5,0.5
"7952",7944,1,1,2,0.5,0.5
"7953",7945,1,1,2,0.5,0.5
"7954",7946,1,1,2,0.5,0.5
"7955",7947,1,1,2,0.5,0.5
"7956",7948,1,1,2,0.5,0.5
"7957",7949,1,1,2,0.5,0.5
"7958",7950,1,1,2,0.5,0.5
"7959",7951,1,1,2,0.5,0.5
"7960",7952,1,1,2,0.5,0.5
"7961",7953,1,1,2,0.5,0.5
"7962",7954,1,1,2,0.5,0.5
"7963",7955,1,1,2,0.5,0.5
"7964",7956,1,1,2,0.5,0.5
"7965",7957,1,1,2,0.5,0.5
"7966",7958,1,1,2,0.5,0.5
"7967",7959,1,1,2,0.5,0.5
"7968",7960,1,1,2,0.5,0.5
"7969",7961,1,1,2,0.5,0.5
"7970",7962,1,1,2,0.5,0.5
"7971",7963,1,1,2,0.5,0.5
"7972",7964,1,1,2,0.5,0.5
"7973",7965,1,1,2,0.5,0.5
"7974",7966,1,1,2,0.5,0.5
"7975",7967,1,1,2,0.5,0.5
"7976",7968,1,1,2,0.5,0.5
"7977",7969,1,1,2,0.5,0.5
"7978",7970,1,1,2,0.5,0.5
"7979",7971,1,1,2,0.5,0.5
"7980",7972,1,1,2,0.5,0.5
"7981",7973,1,1,2,0.5,0.5
"7982",7974,1,1,2,0.5,0.5
"7983",7975,1,1,2,0.5,0.5
"7984",7976,1,1,2,0.5,0.5
"7985",7977,1,1,2,0.5,0.5
"7986",7978,1,1,2,0.5,0.5
"7987",7979,1,1,2,0.5,0.5
"7988",7980,1,1,2,0.5,0.5
"7989",7981,1,1,2,0.5,0.5
"7990",7982,1,1,2,0.5,0.5
"7991",7983,1,1,2,0.5,0.5
"7992",7984,1,1,2,0.5,0.5
"7993",7985,1,1,2,0.5,0.5
"7994",7986,1,1,2,0.5,0.5
"7995",7987,1,1,2,0.5,0.5
"7996",7988,1,1,2,0.5,0.5
"7997",7989,1,1,2,0.5,0.5
"7998",7990,1,1,2,0.5,0.5
"7999",7991,1,1,2,0.5,0.5
"8000",7992,1,1,2,0.5,0.5
"8001",7993,1,1,2,0.5,0.5
"8002",7994,1,1,2,0.5,0.5
"8003",7995,1,1,2,0.5,0.5
"8004",7996,1,1,2,0.5,0.5
"8005",7997,1,1,2,0.5,0.5
"8006",7998,1,1,2,0.5,0.5
"8007",7999,1,1,2,0.5,0.5
"8008",8000,1,1,2,0.5,0.5
"8009",8001,1,1,2,0.5,0.5
"8010",8002,1,1,2,0.5,0.5
"8011",8003,1,1,2,0.5,0.5
"8012",8004,1,1,2,0.5,0.5
"8013",8005,1,1,2,0.5,0.5
"8014",8006,1,1,2,0.5,0.5
"8015",8007,1,1,2,0.5,0.5
"8016",8008,1,1,2,0.5,0.5
"8017",8009,1,1,2,0.5,0.5
"8018",8010,1,1,2,0.5,0.5
"8019",8011,1,1,2,0.5,0.5
"8020",8012,1,1,2,0.5,0.5
"8021",8013,1,1,2,0.5,0.5
"8022",8014,1,1,2,0.5,0.5
"8023",8015,1,1,2,0.5,0.5
"8024",8016,1,1,2,0.5,0.5
"8025",8017,1,1,2,0.5,0.5
"8026",8018,1,1,2,0.5,0.5
"8027",8019,1,1,2,0.5,0.5
"8028",8020,1,1,2,0.5,0.5
"8029",8021,1,1,2,0.5,0.5
"8030",8022,1,1,2,0.5,0.5
"8031",8023,1,1,2,0.5,0.5
"8032",8024,1,1,2,0.5,0.5
"8033",8025,1,1,2,0.5,0.5
"8034",8026,1,1,2,0.5,0.5
"8035",8027,1,1,2,0.5,0.5
"8036",8028,1,1,2,0.5,0.5
"8037",8029,1,1,2,0.5,0.5
"8038",8030,1,1,2,0.5,0.5
"8039",8031,1,1,2,0.5,0.5
"8040",8032,1,1,2,0.5,0.5
"8041",8033,1,1,2,0.5,0.5
"8042",8034,1,1,2,0.5,0.5
"8043",8035,1,1,2,0.5,0.5
"8044",8036,1,1,2,0.5,0.5
"8045",8037,1,1,2,0.5,0.5
"8046",8038,1,1,2,0.5,0.5
"8047",8039,1,1,2,0.5,0.5
"8048",8040,1,1,2,0.5,0.5
"8049",8041,1,1,2,0.5,0.5
"8050",8042,1,1,2,0.5,0.5
"8051",8043,1,1,2,0.5,0.5
"8052",8044,1,1,2,0.5,0.5
"8053",8045,1,1,2,0.5,0.5
"8054",8046,1,1,2,0.5,0.5
"8055",8047,1,1,2,0.5,0.5
"8056",8048,1,1,2,0.5,0.5
"8057",8049,1,1,2,0.5,0.5
"8058",8050,1,1,2,0.5,0.5
"8059",8051,1,1,2,0.5,0.5
"8060",8052,1,1,2,0.5,0.5
"8061",8053,1,1,2,0.5,0.5
"8062",8054,1,1,2,0.5,0.5
"8063",8055,1,1,2,0.5,0.5
"8064",8056,1,1,2,0.5,0.5
"8065",8057,1,1,2,0.5,0.5
"8066",8058,1,1,2,0.5,0.5
"8067",8059,1,1,2,0.5,0.5
"8068",8060,1,1,2,0.5,0.5
"8069",8061,1,1,2,0.5,0.5
"8070",8062,1,1,2,0.5,0.5
"8071",8063,1,1,2,0.5,0.5
"8072",8064,1,1,2,0.5,0.5
"8073",8065,1,1,2,0.5,0.5
"8074",8066,1,1,2,0.5,0.5
"8075",8067,1,1,2,0.5,0.5
"8076",8068,1,1,2,0.5,0.5
"8077",8069,1,1,2,0.5,0.5
"8078",8070,1,1,2,0.5,0.5
"8079",8071,1,1,2,0.5,0.5
"8080",8072,1,1,2,0.5,0.5
"8081",8073,1,1,2,0.5,0.5
"8082",8074,1,1,2,0.5,0.5
"8083",8075,1,1,2,0.5,0.5
"8084",8076,1,1,2,0.5,0.5
"8085",8077,1,1,2,0.5,0.5
"8086",8078,1,1,2,0.5,0.5
"8087",8079,1,1,2,0.5,0.5
"8088",8080,1,1,2,0.5,0.5
"8089",8081,1,1,2,0.5,0.5
"8090",8082,1,1,2,0.5,0.5
"8091",8083,1,1,2,0.5,0.5
"8092",8084,1,1,2,0.5,0.5
"8093",8085,1,1,2,0.5,0.5
"8094",8086,1,1,2,0.5,0.5
"8095",8087,1,1,2,0.5,0.5
"8096",8088,1,1,2,0.5,0.5
"8097",8089,1,1,2,0.5,0.5
"8098",8090,1,1,2,0.5,0.5
"8099",8091,1,1,2,0.5,0.5
"8100",8092,1,1,2,0.5,0.5
"8101",8093,1,1,2,0.5,0.5
"8102",8094,1,1,2,0.5,0.5
"8103",8095,1,1,2,0.5,0.5
"8104",8096,1,1,2,0.5,0.5
"8105",8097,1,1,2,0.5,0.5
"8106",8098,1,1,2,0.5,0.5
"8107",8099,1,1,2,0.5,0.5
"8108",8100,1,1,2,0.5,0.5
"8109",8101,1,1,2,0.5,0.5
"8110",8102,1,1,2,0.5,0.5
"8111",8103,1,1,2,0.5,0.5
"8112",8104,1,1,2,0.5,0.5
"8113",8105,1,1,2,0.5,0.5
"8114",8106,1,1,2,0.5,0.5
"8115",8107,1,1,2,0.5,0.5
"8116",8108,1,1,2,0.5,0.5
"8117",8109,1,1,2,0.5,0.5
"8118",8110,1,1,2,0.5,0.5
"8119",8111,1,1,2,0.5,0.5
"8120",8112,1,1,2,0.5,0.5
"8121",8113,1,1,2,0.5,0.5
"8122",8114,1,1,2,0.5,0.5
"8123",8115,1,1,2,0.5,0.5
"8124",8116,1,1,2,0.5,0.5
"8125",8117,1,1,2,0.5,0.5
"8126",8118,1,1,2,0.5,0.5
"8127",8119,1,1,2,0.5,0.5
"8128",8120,1,1,2,0.5,0.5
"8129",8121,1,1,2,0.5,0.5
"8130",8122,1,1,2,0.5,0.5
"8131",8123,1,1,2,0.5,0.5
"8132",8124,1,1,2,0.5,0.5
"8133",8125,1,1,2,0.5,0.5
"8134",8126,1,1,2,0.5,0.5
"8135",8127,1,1,2,0.5,0.5
"8136",8128,1,1,2,0.5,0.5
"8137",8129,1,1,2,0.5,0.5
"8138",8130,1,1,2,0.5,0.5
"8139",8131,1,1,2,0.5,0.5
"8140",8132,1,1,2,0.5,0.5
"8141",8133,1,1,2,0.5,0.5
"8142",8134,1,1,2,0.5,0.5
"8143",8135,1,1,2,0.5,0.5
"8144",8136,1,1,2,0.5,0.5
"8145",8137,1,1,2,0.5,0.5
"8146",8138,1,1,2,0.5,0.5
"8147",8139,1,1,2,0.5,0.5
"8148",8140,1,1,2,0.5,0.5
"8149",8141,1,1,2,0.5,0.5
"8150",8142,1,1,2,0.5,0.5
"8151",8143,1,1,2,0.5,0.5
"8152",8144,1,1,2,0.5,0.5
"8153",8145,1,1,2,0.5,0.5
"8154",8146,1,1,2,0.5,0.5
"8155",8147,1,1,2,0.5,0.5
"8156",8148,1,1,2,0.5,0.5
"8157",8149,1,1,2,0.5,0.5
"8158",8150,1,1,2,0.5,0.5
"8159",8151,1,1,2,0.5,0.5
"8160",8152,1,1,2,0.5,0.5
"8161",8153,1,1,2,0.5,0.5
"8162",8154,1,1,2,0.5,0.5
"8163",8155,1,1,2,0.5,0.5
"8164",8156,1,1,2,0.5,0.5
"8165",8157,1,1,2,0.5,0.5
"8166",8158,1,1,2,0.5,0.5
"8167",8159,1,1,2,0.5,0.5
"8168",8160,1,1,2,0.5,0.5
"8169",8161,1,1,2,0.5,0.5
"8170",8162,1,1,2,0.5,0.5
"8171",8163,1,1,2,0.5,0.5
"8172",8164,1,1,2,0.5,0.5
"8173",8165,1,1,2,0.5,0.5
"8174",8166,1,1,2,0.5,0.5
"8175",8167,1,1,2,0.5,0.5
"8176",8168,1,1,2,0.5,0.5
"8177",8169,1,1,2,0.5,0.5
"8178",8170,1,1,2,0.5,0.5
"8179",8171,1,1,2,0.5,0.5
"8180",8172,1,1,2,0.5,0.5
"8181",8173,1,1,2,0.5,0.5
"8182",8174,1,1,2,0.5,0.5
"8183",8175,1,1,2,0.5,0.5
"8184",8176,1,1,2,0.5,0.5
"8185",8177,1,1,2,0.5,0.5
"8186",8178,1,1,2,0.5,0.5
"8187",8179,1,1,2,0.5,0.5
"8188",8180,1,1,2,0.5,0.5
"8189",8181,1,1,2,0.5,0.5
"8190",8182,1,1,2,0.5,0.5
"8191",8183,1,1,2,0.5,0.5
"8192",8184,1,1,2,0.5,0.5
"8193",8185,1,1,2,0.5,0.5
"8194",8186,1,1,2,0.5,0.5
"8195",8187,1,1,2,0.5,0.5
"8196",8188,1,1,2,0.5,0.5
"8197",8189,1,1,2,0.5,0.5
"8198",8190,1,1,2,0.5,0.5
"8199",8191,1,1,2,0.5,0.5
"8200",8192,1,1,2,0.5,0.5
"8201",8193,1,1,2,0.5,0.5
"8202",8194,1,1,2,0.5,0.5
"8203",8195,1,1,2,0.5,0.5
"8204",8196,1,1,2,0.5,0.5
"8205",8197,1,1,2,0.5,0.5
"8206",8198,1,1,2,0.5,0.5
"8207",8199,1,1,2,0.5,0.5
"8208",8200,1,1,2,0.5,0.5
"8209",8201,1,1,2,0.5,0.5
"8210",8202,1,1,2,0.5,0.5
"8211",8203,1,1,2,0.5,0.5
"8212",8204,1,1,2,0.5,0.5
"8213",8205,1,1,2,0.5,0.5
"8214",8206,1,1,2,0.5,0.5
"8215",8207,1,1,2,0.5,0.5
"8216",8208,1,1,2,0.5,0.5
"8217",8209,1,1,2,0.5,0.5
"8218",8210,1,1,2,0.5,0.5
"8219",8211,1,1,2,0.5,0.5
"8220",8212,1,1,2,0.5,0.5
"8221",8213,1,1,2,0.5,0.5
"8222",8214,1,1,2,0.5,0.5
"8223",8215,1,1,2,0.5,0.5
"8224",8216,1,1,2,0.5,0.5
"8225",8217,1,1,2,0.5,0.5
"8226",8218,1,1,2,0.5,0.5
"8227",8219,1,1,2,0.5,0.5
"8228",8220,1,1,2,0.5,0.5
"8229",8221,1,1,2,0.5,0.5
"8230",8222,1,1,2,0.5,0.5
"8231",8223,1,1,2,0.5,0.5
"8232",8224,1,1,2,0.5,0.5
"8233",8225,1,1,2,0.5,0.5
"8234",8226,1,1,2,0.5,0.5
"8235",8227,1,1,2,0.5,0.5
"8236",8228,1,1,2,0.5,0.5
"8237",8229,1,1,2,0.5,0.5
"8238",8230,1,1,2,0.5,0.5
"8239",8231,1,1,2,0.5,0.5
"8240",8232,1,1,2,0.5,0.5
"8241",8233,1,1,2,0.5,0.5
"8242",8234,1,1,2,0.5,0.5
"8243",8235,1,1,2,0.5,0.5
"8244",8236,1,1,2,0.5,0.5
"8245",8237,1,1,2,0.5,0.5
"8246",8238,1,1,2,0.5,0.5
"8247",8239,1,1,2,0.5,0.5
"8248",8240,1,1,2,0.5,0.5
"8249",8241,1,1,2,0.5,0.5
"8250",8242,1,1,2,0.5,0.5
"8251",8243,1,1,2,0.5,0.5
"8252",8244,1,1,2,0.5,0.5
"8253",8245,1,1,2,0.5,0.5
"8254",8246,1,1,2,0.5,0.5
"8255",8247,1,1,2,0.5,0.5
"8256",8248,1,1,2,0.5,0.5
"8257",8249,1,1,2,0.5,0.5
"8258",8250,1,1,2,0.5,0.5
"8259",8251,1,1,2,0.5,0.5
"8260",8252,1,1,2,0.5,0.5
"8261",8253,1,1,2,0.5,0.5
"8262",8254,1,1,2,0.5,0.5
"8263",8255,1,1,2,0.5,0.5
"8264",8256,1,1,2,0.5,0.5
"8265",8257,1,1,2,0.5,0.5
"8266",8258,1,1,2,0.5,0.5
"8267",8259,1,1,2,0.5,0.5
"8268",8260,1,1,2,0.5,0.5
"8269",8261,1,1,2,0.5,0.5
"8270",8262,1,1,2,0.5,0.5
"8271",8263,1,1,2,0.5,0.5
"8272",8264,1,1,2,0.5,0.5
"8273",8265,1,1,2,0.5,0.5
"8274",8266,1,1,2,0.5,0.5
"8275",8267,1,1,2,0.5,0.5
"8276",8268,1,1,2,0.5,0.5
"8277",8269,1,1,2,0.5,0.5
"8278",8270,1,1,2,0.5,0.5
"8279",8271,1,1,2,0.5,0.5
"8280",8272,1,1,2,0.5,0.5
"8281",8273,1,1,2,0.5,0.5
"8282",8274,1,1,2,0.5,0.5
"8283",8275,1,1,2,0.5,0.5
"8284",8276,1,1,2,0.5,0.5
"8285",8277,1,1,2,0.5,0.5
"8286",8278,1,1,2,0.5,0.5
"8287",8279,1,1,2,0.5,0.5
"8288",8280,1,1,2,0.5,0.5
"8289",8281,1,1,2,0.5,0.5
"8290",8282,1,1,2,0.5,0.5
"8291",8283,1,1,2,0.5,0.5
"8292",8284,1,1,2,0.5,0.5
"8293",8285,1,1,2,0.5,0.5
"8294",8286,1,1,2,0.5,0.5
"8295",8287,1,1,2,0.5,0.5
"8296",8288,1,1,2,0.5,0.5
"8297",8289,1,1,2,0.5,0.5
"8298",8290,1,1,2,0.5,0.5
"8299",8291,1,1,2,0.5,0.5
"8300",8292,1,1,2,0.5,0.5
"8301",8293,1,1,2,0.5,0.5
"8302",8294,1,1,2,0.5,0.5
"8303",8295,1,1,2,0.5,0.5
"8304",8296,1,1,2,0.5,0.5
"8305",8297,1,1,2,0.5,0.5
"8306",8298,1,1,2,0.5,0.5
"8307",8299,1,1,2,0.5,0.5
"8308",8300,1,1,2,0.5,0.5
"8309",8301,1,1,2,0.5,0.5
"8310",8302,1,1,2,0.5,0.5
"8311",8303,1,1,2,0.5,0.5
"8312",8304,1,1,2,0.5,0.5
"8313",8305,1,1,2,0.5,0.5
"8314",8306,1,1,2,0.5,0.5
"8315",8307,1,1,2,0.5,0.5
"8316",8308,1,1,2,0.5,0.5
"8317",8309,1,1,2,0.5,0.5
"8318",8310,1,1,2,0.5,0.5
"8319",8311,1,1,2,0.5,0.5
"8320",8312,1,1,2,0.5,0.5
"8321",8313,1,1,2,0.5,0.5
"8322",8314,1,1,2,0.5,0.5
"8323",8315,1,1,2,0.5,0.5
"8324",8316,1,1,2,0.5,0.5
"8325",8317,1,1,2,0.5,0.5
"8326",8318,1,1,2,0.5,0.5
"8327",8319,1,1,2,0.5,0.5
"8328",8320,1,1,2,0.5,0.5
"8329",8321,1,1,2,0.5,0.5
"8330",8322,1,1,2,0.5,0.5
"8331",8323,1,1,2,0.5,0.5
"8332",8324,1,1,2,0.5,0.5
"8333",8325,1,1,2,0.5,0.5
"8334",8326,1,1,2,0.5,0.5
"8335",8327,1,1,2,0.5,0.5
"8336",8328,1,1,2,0.5,0.5
"8337",8329,1,1,2,0.5,0.5
"8338",8330,1,1,2,0.5,0.5
"8339",8331,1,1,2,0.5,0.5
"8340",8332,1,1,2,0.5,0.5
"8341",8333,1,1,2,0.5,0.5
"8342",8334,1,1,2,0.5,0.5
"8343",8335,1,1,2,0.5,0.5
"8344",8336,1,1,2,0.5,0.5
"8345",8337,1,1,2,0.5,0.5
"8346",8338,1,1,2,0.5,0.5
"8347",8339,1,1,2,0.5,0.5
"8348",8340,1,1,2,0.5,0.5
"8349",8341,1,1,2,0.5,0.5
"8350",8342,1,1,2,0.5,0.5
"8351",8343,1,1,2,0.5,0.5
"8352",8344,1,1,2,0.5,0.5
"8353",8345,1,1,2,0.5,0.5
"8354",8346,1,1,2,0.5,0.5
"8355",8347,1,1,2,0.5,0.5
"8356",8348,1,1,2,0.5,0.5
"8357",8349,1,1,2,0.5,0.5
"8358",8350,1,1,2,0.5,0.5
"8359",8351,1,1,2,0.5,0.5
"8360",8352,1,1,2,0.5,0.5
"8361",8353,1,1,2,0.5,0.5
"8362",8354,1,1,2,0.5,0.5
"8363",8355,1,1,2,0.5,0.5
"8364",8356,1,1,2,0.5,0.5
"8365",8357,1,1,2,0.5,0.5
"8366",8358,1,1,2,0.5,0.5
"8367",8359,1,1,2,0.5,0.5
"8368",8360,1,1,2,0.5,0.5
"8369",8361,1,1,2,0.5,0.5
"8370",8362,1,1,2,0.5,0.5
"8371",8363,1,1,2,0.5,0.5
"8372",8364,1,1,2,0.5,0.5
"8373",8365,1,1,2,0.5,0.5
"8374",8366,1,1,2,0.5,0.5
"8375",8367,1,1,2,0.5,0.5
"8376",8368,1,1,2,0.5,0.5
"8377",8369,1,1,2,0.5,0.5
"8378",8370,1,1,2,0.5,0.5
"8379",8371,1,1,2,0.5,0.5
"8380",8372,1,1,2,0.5,0.5
"8381",8373,1,1,2,0.5,0.5
"8382",8374,1,1,2,0.5,0.5
"8383",8375,1,1,2,0.5,0.5
"8384",8376,1,1,2,0.5,0.5
"8385",8377,1,1,2,0.5,0.5
"8386",8378,1,1,2,0.5,0.5
"8387",8379,1,1,2,0.5,0.5
"8388",8380,1,1,2,0.5,0.5
"8389",8381,1,1,2,0.5,0.5
"8390",8382,1,1,2,0.5,0.5
"8391",8383,1,1,2,0.5,0.5
"8392",8384,1,1,2,0.5,0.5
"8393",8385,1,1,2,0.5,0.5
"8394",8386,1,1,2,0.5,0.5
"8395",8387,1,1,2,0.5,0.5
"8396",8388,1,1,2,0.5,0.5
"8397",8389,1,1,2,0.5,0.5
"8398",8390,1,1,2,0.5,0.5
"8399",8391,1,1,2,0.5,0.5
"8400",8392,1,1,2,0.5,0.5
"8401",8393,1,1,2,0.5,0.5
"8402",8394,1,1,2,0.5,0.5
"8403",8395,1,1,2,0.5,0.5
"8404",8396,1,1,2,0.5,0.5
"8405",8397,1,1,2,0.5,0.5
"8406",8398,1,1,2,0.5,0.5
"8407",8399,1,1,2,0.5,0.5
"8408",8400,1,1,2,0.5,0.5
"8409",8401,1,1,2,0.5,0.5
"8410",8402,1,1,2,0.5,0.5
"8411",8403,1,1,2,0.5,0.5
"8412",8404,1,1,2,0.5,0.5
"8413",8405,1,1,2,0.5,0.5
"8414",8406,1,1,2,0.5,0.5
"8415",8407,1,1,2,0.5,0.5
"8416",8408,1,1,2,0.5,0.5
"8417",8409,1,1,2,0.5,0.5
"8418",8410,1,1,2,0.5,0.5
"8419",8411,1,1,2,0.5,0.5
"8420",8412,1,1,2,0.5,0.5
"8421",8413,1,1,2,0.5,0.5
"8422",8414,1,1,2,0.5,0.5
"8423",8415,1,1,2,0.5,0.5
"8424",8416,1,1,2,0.5,0.5
"8425",8417,1,1,2,0.5,0.5
"8426",8418,1,1,2,0.5,0.5
"8427",8419,1,1,2,0.5,0.5
"8428",8420,1,1,2,0.5,0.5
"8429",8421,1,1,2,0.5,0.5
"8430",8422,1,1,2,0.5,0.5
"8431",8423,1,1,2,0.5,0.5
"8432",8424,1,1,2,0.5,0.5
"8433",8425,1,1,2,0.5,0.5
"8434",8426,1,1,2,0.5,0.5
"8435",8427,1,1,2,0.5,0.5
"8436",8428,1,1,2,0.5,0.5
"8437",8429,1,1,2,0.5,0.5
"8438",8430,1,1,2,0.5,0.5
"8439",8431,1,1,2,0.5,0.5
"8440",8433,1,1,2,0.5,0.5
"8441",8434,1,1,2,0.5,0.5
"8442",8435,1,1,2,0.5,0.5
"8443",8436,1,1,2,0.5,0.5
"8444",8437,1,1,2,0.5,0.5
"8445",8438,1,1,2,0.5,0.5
"8446",8439,1,1,2,0.5,0.5
"8447",8440,1,1,2,0.5,0.5
"8448",8441,1,1,2,0.5,0.5
"8449",8442,1,1,2,0.5,0.5
"8450",8443,1,1,2,0.5,0.5
"8451",8444,1,1,2,0.5,0.5
"8452",8445,1,1,2,0.5,0.5
"8453",8446,1,1,2,0.5,0.5
"8454",8447,1,1,2,0.5,0.5
"8455",8448,1,1,2,0.5,0.5
"8456",8449,1,1,2,0.5,0.5
"8457",8450,1,1,2,0.5,0.5
"8458",8451,1,1,2,0.5,0.5
"8459",8452,1,1,2,0.5,0.5
"8460",8453,1,1,2,0.5,0.5
"8461",8454,1,1,2,0.5,0.5
"8462",8455,1,1,2,0.5,0.5
"8463",8456,1,1,2,0.5,0.5
"8464",8457,1,1,2,0.5,0.5
"8465",8458,1,1,2,0.5,0.5
"8466",8459,1,1,2,0.5,0.5
"8467",8460,1,1,2,0.5,0.5
"8468",8461,1,1,2,0.5,0.5
"8469",8462,1,1,2,0.5,0.5
"8470",8463,1,1,2,0.5,0.5
"8471",8464,1,1,2,0.5,0.5
"8472",8465,1,1,2,0.5,0.5
"8473",8466,1,1,2,0.5,0.5
"8474",8467,1,1,2,0.5,0.5
"8475",8468,1,1,2,0.5,0.5
"8476",8469,1,1,2,0.5,0.5
"8477",8470,1,1,2,0.5,0.5
"8478",8471,1,1,2,0.5,0.5
"8479",8472,1,1,2,0.5,0.5
"8480",8473,1,1,2,0.5,0.5
"8481",8474,1,1,2,0.5,0.5
"8482",8475,1,1,2,0.5,0.5
"8483",8476,1,1,2,0.5,0.5
"8484",8477,1,1,2,0.5,0.5
"8485",8478,1,1,2,0.5,0.5
"8486",8479,1,1,2,0.5,0.5
"8487",8480,1,1,2,0.5,0.5
"8488",8481,1,1,2,0.5,0.5
"8489",8482,1,1,2,0.5,0.5
"8490",8483,1,1,2,0.5,0.5
"8491",8485,1,1,2,0.5,0.5
"8492",8486,1,1,2,0.5,0.5
"8493",8487,1,1,2,0.5,0.5
"8494",8488,1,1,2,0.5,0.5
"8495",8489,1,1,2,0.5,0.5
"8496",8490,1,1,2,0.5,0.5
"8497",8491,1,1,2,0.5,0.5
"8498",8492,1,1,2,0.5,0.5
"8499",8493,1,1,2,0.5,0.5
"8500",8494,1,1,2,0.5,0.5
"8501",8495,1,1,2,0.5,0.5
"8502",8496,1,1,2,0.5,0.5
"8503",8497,1,1,2,0.5,0.5
"8504",8498,1,1,2,0.5,0.5
"8505",8499,1,1,2,0.5,0.5
"8506",8500,1,1,2,0.5,0.5
"8507",8501,1,1,2,0.5,0.5
"8508",8502,1,1,2,0.5,0.5
"8509",8503,1,1,2,0.5,0.5
"8510",8504,1,1,2,0.5,0.5
"8511",8505,1,1,2,0.5,0.5
"8512",8506,1,1,2,0.5,0.5
"8513",8507,1,1,2,0.5,0.5
"8514",8508,1,1,2,0.5,0.5
"8515",8509,1,1,2,0.5,0.5
"8516",8510,1,1,2,0.5,0.5
"8517",8511,1,1,2,0.5,0.5
"8518",8512,1,1,2,0.5,0.5
"8519",8513,1,1,2,0.5,0.5
"8520",8514,1,1,2,0.5,0.5
"8521",8515,1,1,2,0.5,0.5
"8522",8516,1,1,2,0.5,0.5
"8523",8517,1,1,2,0.5,0.5
"8524",8518,1,1,2,0.5,0.5
"8525",8519,1,1,2,0.5,0.5
"8526",8520,1,1,2,0.5,0.5
"8527",8521,1,1,2,0.5,0.5
"8528",8522,1,1,2,0.5,0.5
"8529",8523,1,1,2,0.5,0.5
"8530",8524,1,1,2,0.5,0.5
"8531",8525,1,1,2,0.5,0.5
"8532",8526,1,1,2,0.5,0.5
"8533",8527,1,1,2,0.5,0.5
"8534",8528,1,1,2,0.5,0.5
"8535",8529,1,1,2,0.5,0.5
"8536",8530,1,1,2,0.5,0.5
"8537",8531,1,1,2,0.5,0.5
"8538",8532,1,1,2,0.5,0.5
"8539",8533,1,1,2,0.5,0.5
"8540",8534,1,1,2,0.5,0.5
"8541",8535,1,1,2,0.5,0.5
"8542",8536,1,1,2,0.5,0.5
"8543",8537,1,1,2,0.5,0.5
"8544",8538,1,1,2,0.5,0.5
"8545",8539,1,1,2,0.5,0.5
"8546",8540,1,1,2,0.5,0.5
"8547",8541,1,1,2,0.5,0.5
"8548",8542,1,1,2,0.5,0.5
"8549",8543,1,1,2,0.5,0.5
"8550",8544,1,1,2,0.5,0.5
"8551",8545,1,1,2,0.5,0.5
"8552",8546,1,1,2,0.5,0.5
"8553",8547,1,1,2,0.5,0.5
"8554",8548,1,1,2,0.5,0.5
"8555",8549,1,1,2,0.5,0.5
"8556",8550,1,1,2,0.5,0.5
"8557",8551,1,1,2,0.5,0.5
"8558",8552,1,1,2,0.5,0.5
"8559",8553,1,1,2,0.5,0.5
"8560",8554,1,1,2,0.5,0.5
"8561",8555,1,1,2,0.5,0.5
"8562",8556,1,1,2,0.5,0.5
"8563",8557,1,1,2,0.5,0.5
"8564",8558,1,1,2,0.5,0.5
"8565",8559,1,1,2,0.5,0.5
"8566",8560,1,1,2,0.5,0.5
"8567",8561,1,1,2,0.5,0.5
"8568",8562,1,1,2,0.5,0.5
"8569",8563,1,1,2,0.5,0.5
"8570",8564,1,1,2,0.5,0.5
"8571",8565,1,1,2,0.5,0.5
"8572",8566,1,1,2,0.5,0.5
"8573",8567,1,1,2,0.5,0.5
"8574",8568,1,1,2,0.5,0.5
"8575",8569,1,1,2,0.5,0.5
"8576",8570,1,1,2,0.5,0.5
"8577",8571,1,1,2,0.5,0.5
"8578",8572,1,1,2,0.5,0.5
"8579",8573,1,1,2,0.5,0.5
"8580",8574,1,1,2,0.5,0.5
"8581",8575,1,1,2,0.5,0.5
"8582",8576,1,1,2,0.5,0.5
"8583",8577,1,1,2,0.5,0.5
"8584",8578,1,1,2,0.5,0.5
"8585",8579,1,1,2,0.5,0.5
"8586",8580,1,1,2,0.5,0.5
"8587",8581,1,1,2,0.5,0.5
"8588",8582,1,1,2,0.5,0.5
"8589",8583,1,1,2,0.5,0.5
"8590",8584,1,1,2,0.5,0.5
"8591",8585,1,1,2,0.5,0.5
"8592",8586,1,1,2,0.5,0.5
"8593",8587,1,1,2,0.5,0.5
"8594",8589,1,1,2,0.5,0.5
"8595",8590,1,1,2,0.5,0.5
"8596",8591,1,1,2,0.5,0.5
"8597",8592,1,1,2,0.5,0.5
"8598",8593,1,1,2,0.5,0.5
"8599",8594,1,1,2,0.5,0.5
"8600",8595,1,1,2,0.5,0.5
"8601",8596,1,1,2,0.5,0.5
"8602",8597,1,1,2,0.5,0.5
"8603",8598,1,1,2,0.5,0.5
"8604",8599,1,1,2,0.5,0.5
"8605",8600,1,1,2,0.5,0.5
"8606",8601,1,1,2,0.5,0.5
"8607",8602,1,1,2,0.5,0.5
"8608",8603,1,1,2,0.5,0.5
"8609",8604,1,1,2,0.5,0.5
"8610",8605,1,1,2,0.5,0.5
"8611",8606,1,1,2,0.5,0.5
"8612",8607,1,1,2,0.5,0.5
"8613",8608,1,1,2,0.5,0.5
"8614",8609,1,1,2,0.5,0.5
"8615",8610,1,1,2,0.5,0.5
"8616",8611,1,1,2,0.5,0.5
"8617",8612,1,1,2,0.5,0.5
"8618",8613,1,1,2,0.5,0.5
"8619",8614,1,1,2,0.5,0.5
"8620",8615,1,1,2,0.5,0.5
"8621",8616,1,1,2,0.5,0.5
"8622",8617,1,1,2,0.5,0.5
"8623",8618,1,1,2,0.5,0.5
"8624",8619,1,1,2,0.5,0.5
"8625",8620,1,1,2,0.5,0.5
"8626",8621,1,1,2,0.5,0.5
"8627",8622,1,1,2,0.5,0.5
"8628",8623,1,1,2,0.5,0.5
"8629",8624,1,1,2,0.5,0.5
"8630",8625,1,1,2,0.5,0.5
"8631",8626,1,1,2,0.5,0.5
"8632",8627,1,1,2,0.5,0.5
"8633",8628,1,1,2,0.5,0.5
"8634",8629,1,1,2,0.5,0.5
"8635",8630,1,1,2,0.5,0.5
"8636",8631,1,1,2,0.5,0.5
"8637",8632,1,1,2,0.5,0.5
"8638",8633,1,1,2,0.5,0.5
"8639",8634,1,1,2,0.5,0.5
"8640",8635,1,1,2,0.5,0.5
"8641",8636,1,1,2,0.5,0.5
"8642",8638,1,1,2,0.5,0.5
"8643",8639,1,1,2,0.5,0.5
"8644",8640,1,1,2,0.5,0.5
"8645",8641,1,1,2,0.5,0.5
"8646",8642,1,1,2,0.5,0.5
"8647",8643,1,1,2,0.5,0.5
"8648",8644,1,1,2,0.5,0.5
"8649",8645,1,1,2,0.5,0.5
"8650",8646,1,1,2,0.5,0.5
"8651",8647,1,1,2,0.5,0.5
"8652",8648,1,1,2,0.5,0.5
"8653",8649,1,1,2,0.5,0.5
"8654",8650,1,1,2,0.5,0.5
"8655",8651,1,1,2,0.5,0.5
"8656",8652,1,1,2,0.5,0.5
"8657",8653,1,1,2,0.5,0.5
"8658",8654,1,1,2,0.5,0.5
"8659",8655,1,1,2,0.5,0.5
"8660",8657,1,1,2,0.5,0.5
"8661",8658,1,1,2,0.5,0.5
"8662",8659,1,1,2,0.5,0.5
"8663",8660,1,1,2,0.5,0.5
"8664",8661,1,1,2,0.5,0.5
"8665",8662,1,1,2,0.5,0.5
"8666",8663,1,1,2,0.5,0.5
"8667",8664,1,1,2,0.5,0.5
"8668",8665,1,1,2,0.5,0.5
"8669",8666,1,1,2,0.5,0.5
"8670",8667,1,1,2,0.5,0.5
"8671",8668,1,1,2,0.5,0.5
"8672",8669,1,1,2,0.5,0.5
"8673",8670,1,1,2,0.5,0.5
"8674",8671,1,1,2,0.5,0.5
"8675",8672,1,1,2,0.5,0.5
"8676",8673,1,1,2,0.5,0.5
"8677",8674,1,1,2,0.5,0.5
"8678",8675,1,1,2,0.5,0.5
"8679",8676,1,1,2,0.5,0.5
"8680",8677,1,1,2,0.5,0.5
"8681",8678,1,1,2,0.5,0.5
"8682",8679,1,1,2,0.5,0.5
"8683",8680,1,1,2,0.5,0.5
"8684",8681,1,1,2,0.5,0.5
"8685",8682,1,1,2,0.5,0.5
"8686",8683,1,1,2,0.5,0.5
"8687",8684,1,1,2,0.5,0.5
"8688",8685,1,1,2,0.5,0.5
"8689",8686,1,1,2,0.5,0.5
"8690",8687,1,1,2,0.5,0.5
"8691",8688,1,1,2,0.5,0.5
"8692",8689,1,1,2,0.5,0.5
"8693",8690,1,1,2,0.5,0.5
"8694",8691,1,1,2,0.5,0.5
"8695",8692,1,1,2,0.5,0.5
"8696",8693,1,1,2,0.5,0.5
"8697",8694,1,1,2,0.5,0.5
"8698",8695,1,1,2,0.5,0.5
"8699",8696,1,1,2,0.5,0.5
"8700",8697,1,1,2,0.5,0.5
"8701",8698,1,1,2,0.5,0.5
"8702",8699,1,1,2,0.5,0.5
"8703",8700,1,1,2,0.5,0.5
"8704",8701,1,1,2,0.5,0.5
"8705",8702,1,1,2,0.5,0.5
"8706",8703,1,1,2,0.5,0.5
"8707",8704,1,1,2,0.5,0.5
"8708",8705,1,1,2,0.5,0.5
"8709",8706,1,1,2,0.5,0.5
"8710",8707,1,1,2,0.5,0.5
"8711",8708,1,1,2,0.5,0.5
"8712",8710,1,1,2,0.5,0.5
"8713",8711,1,1,2,0.5,0.5
"8714",8712,1,1,2,0.5,0.5
"8715",8713,1,1,2,0.5,0.5
"8716",8714,1,1,2,0.5,0.5
"8717",8715,1,1,2,0.5,0.5
"8718",8716,1,1,2,0.5,0.5
"8719",8717,1,1,2,0.5,0.5
"8720",8718,1,1,2,0.5,0.5
"8721",8719,1,1,2,0.5,0.5
"8722",8720,1,1,2,0.5,0.5
"8723",8721,1,1,2,0.5,0.5
"8724",8722,1,1,2,0.5,0.5
"8725",8723,1,1,2,0.5,0.5
"8726",8724,1,1,2,0.5,0.5
"8727",8725,1,1,2,0.5,0.5
"8728",8726,1,1,2,0.5,0.5
"8729",8727,1,1,2,0.5,0.5
"8730",8728,1,1,2,0.5,0.5
"8731",8729,1,1,2,0.5,0.5
"8732",8730,1,1,2,0.5,0.5
"8733",8731,1,1,2,0.5,0.5
"8734",8732,1,1,2,0.5,0.5
"8735",8733,1,1,2,0.5,0.5
"8736",8734,1,1,2,0.5,0.5
"8737",8735,1,1,2,0.5,0.5
"8738",8736,1,1,2,0.5,0.5
"8739",8737,1,1,2,0.5,0.5
"8740",8738,1,1,2,0.5,0.5
"8741",8739,1,1,2,0.5,0.5
"8742",8740,1,1,2,0.5,0.5
"8743",8741,1,1,2,0.5,0.5
"8744",8742,1,1,2,0.5,0.5
"8745",8743,1,1,2,0.5,0.5
"8746",8744,1,1,2,0.5,0.5
"8747",8745,1,1,2,0.5,0.5
"8748",8746,1,1,2,0.5,0.5
"8749",8747,1,1,2,0.5,0.5
"8750",8748,1,1,2,0.5,0.5
"8751",8749,1,1,2,0.5,0.5
"8752",8750,1,1,2,0.5,0.5
"8753",8751,1,1,2,0.5,0.5
"8754",8752,1,1,2,0.5,0.5
"8755",8753,1,1,2,0.5,0.5
"8756",8754,1,1,2,0.5,0.5
"8757",8755,1,1,2,0.5,0.5
"8758",8756,1,1,2,0.5,0.5
"8759",8757,1,1,2,0.5,0.5
"8760",8759,1,1,2,0.5,0.5
"8761",8760,1,1,2,0.5,0.5
"8762",8761,1,1,2,0.5,0.5
"8763",8763,1,1,2,0.5,0.5
"8764",8764,1,1,2,0.5,0.5
"8765",8765,1,1,2,0.5,0.5
"8766",8766,1,1,2,0.5,0.5
"8767",8767,1,1,2,0.5,0.5
"8768",8768,1,1,2,0.5,0.5
"8769",8769,1,1,2,0.5,0.5
"8770",8770,1,1,2,0.5,0.5
"8771",8771,1,1,2,0.5,0.5
"8772",8772,1,1,2,0.5,0.5
"8773",8773,1,1,2,0.5,0.5
"8774",8774,1,1,2,0.5,0.5
"8775",8775,1,1,2,0.5,0.5
"8776",8776,1,1,2,0.5,0.5
"8777",8777,1,1,2,0.5,0.5
"8778",8778,1,1,2,0.5,0.5
"8779",8779,1,1,2,0.5,0.5
"8780",8780,1,1,2,0.5,0.5
"8781",8781,1,1,2,0.5,0.5
"8782",8782,1,1,2,0.5,0.5
"8783",8783,1,1,2,0.5,0.5
"8784",8784,1,1,2,0.5,0.5
"8785",8785,1,1,2,0.5,0.5
"8786",8786,1,1,2,0.5,0.5
"8787",8787,1,1,2,0.5,0.5
"8788",8788,1,1,2,0.5,0.5
"8789",8789,1,1,2,0.5,0.5
"8790",8790,1,1,2,0.5,0.5
"8791",8791,1,1,2,0.5,0.5
"8792",8792,1,1,2,0.5,0.5
"8793",8793,1,1,2,0.5,0.5
"8794",8794,1,1,2,0.5,0.5
"8795",8795,1,1,2,0.5,0.5
"8796",8796,1,1,2,0.5,0.5
"8797",8797,1,1,2,0.5,0.5
"8798",8798,1,1,2,0.5,0.5
"8799",8799,1,1,2,0.5,0.5
"8800",8800,1,1,2,0.5,0.5
"8801",8801,1,1,2,0.5,0.5
"8802",8802,1,1,2,0.5,0.5
"8803",8803,1,1,2,0.5,0.5
"8804",8804,1,1,2,0.5,0.5
"8805",8805,1,1,2,0.5,0.5
"8806",8806,1,1,2,0.5,0.5
"8807",8807,1,1,2,0.5,0.5
"8808",8808,1,1,2,0.5,0.5
"8809",8809,1,1,2,0.5,0.5
"8810",8810,1,1,2,0.5,0.5
"8811",8811,1,1,2,0.5,0.5
"8812",8812,1,1,2,0.5,0.5
"8813",8813,1,1,2,0.5,0.5
"8814",8814,1,1,2,0.5,0.5
"8815",8815,1,1,2,0.5,0.5
"8816",8816,1,1,2,0.5,0.5
"8817",8817,1,1,2,0.5,0.5
"8818",8818,1,1,2,0.5,0.5
"8819",8819,1,1,2,0.5,0.5
"8820",8820,1,1,2,0.5,0.5
"8821",8821,1,1,2,0.5,0.5
"8822",8822,1,1,2,0.5,0.5
"8823",8823,1,1,2,0.5,0.5
"8824",8824,1,1,2,0.5,0.5
"8825",8825,1,1,2,0.5,0.5
"8826",8826,1,1,2,0.5,0.5
"8827",8827,1,1,2,0.5,0.5
"8828",8828,1,1,2,0.5,0.5
"8829",8829,1,1,2,0.5,0.5
"8830",8830,1,1,2,0.5,0.5
"8831",8831,1,1,2,0.5,0.5
"8832",8832,1,1,2,0.5,0.5
"8833",8833,1,1,2,0.5,0.5
"8834",8834,1,1,2,0.5,0.5
"8835",8835,1,1,2,0.5,0.5
"8836",8836,1,1,2,0.5,0.5
"8837",8837,1,1,2,0.5,0.5
"8838",8838,1,1,2,0.5,0.5
"8839",8839,1,1,2,0.5,0.5
"8840",8840,1,1,2,0.5,0.5
"8841",8841,1,1,2,0.5,0.5
"8842",8842,1,1,2,0.5,0.5
"8843",8843,1,1,2,0.5,0.5
"8844",8844,1,1,2,0.5,0.5
"8845",8845,1,1,2,0.5,0.5
"8846",8846,1,1,2,0.5,0.5
"8847",8847,1,1,2,0.5,0.5
"8848",8848,1,1,2,0.5,0.5
"8849",8849,1,1,2,0.5,0.5
"8850",8850,1,1,2,0.5,0.5
"8851",8851,1,1,2,0.5,0.5
"8852",8852,1,1,2,0.5,0.5
"8853",8853,1,1,2,0.5,0.5
"8854",8854,1,1,2,0.5,0.5
"8855",8855,1,1,2,0.5,0.5
"8856",8856,1,1,2,0.5,0.5
"8857",8857,1,1,2,0.5,0.5
"8858",8858,1,1,2,0.5,0.5
"8859",8859,1,1,2,0.5,0.5
"8860",8860,1,1,2,0.5,0.5
"8861",8861,1,1,2,0.5,0.5
"8862",8862,1,1,2,0.5,0.5
"8863",8863,1,1,2,0.5,0.5
"8864",8864,1,1,2,0.5,0.5
"8865",8865,1,1,2,0.5,0.5
"8866",8866,1,1,2,0.5,0.5
"8867",8867,1,1,2,0.5,0.5
"8868",8868,1,1,2,0.5,0.5
"8869",8869,1,1,2,0.5,0.5
"8870",8870,1,1,2,0.5,0.5
"8871",8871,1,1,2,0.5,0.5
"8872",8872,1,1,2,0.5,0.5
"8873",8873,1,1,2,0.5,0.5
"8874",8874,1,1,2,0.5,0.5
"8875",8875,1,1,2,0.5,0.5
"8876",8876,1,1,2,0.5,0.5
"8877",8877,1,1,2,0.5,0.5
"8878",8878,1,1,2,0.5,0.5
"8879",8879,1,1,2,0.5,0.5
"8880",8880,1,1,2,0.5,0.5
"8881",8881,1,1,2,0.5,0.5
"8882",8882,1,1,2,0.5,0.5
"8883",8883,1,1,2,0.5,0.5
"8884",8884,1,1,2,0.5,0.5
"8885",8885,1,1,2,0.5,0.5
"8886",8886,1,1,2,0.5,0.5
"8887",8887,1,1,2,0.5,0.5
"8888",8888,1,1,2,0.5,0.5
"8889",8889,1,1,2,0.5,0.5
"8890",8890,1,1,2,0.5,0.5
"8891",8891,1,1,2,0.5,0.5
"8892",8892,1,1,2,0.5,0.5
"8893",8893,1,1,2,0.5,0.5
"8894",8894,1,1,2,0.5,0.5
"8895",8895,1,1,2,0.5,0.5
"8896",8896,1,1,2,0.5,0.5
"8897",8897,1,1,2,0.5,0.5
"8898",8898,1,1,2,0.5,0.5
"8899",8899,1,1,2,0.5,0.5
"8900",8900,1,1,2,0.5,0.5
"8901",8901,1,1,2,0.5,0.5
"8902",8902,1,1,2,0.5,0.5
"8903",8903,1,1,2,0.5,0.5
"8904",8904,1,1,2,0.5,0.5
"8905",8905,1,1,2,0.5,0.5
"8906",8906,1,1,2,0.5,0.5
"8907",8907,1,1,2,0.5,0.5
"8908",8908,1,1,2,0.5,0.5
"8909",8909,1,1,2,0.5,0.5
"8910",8910,1,1,2,0.5,0.5
"8911",8911,1,1,2,0.5,0.5
"8912",8912,1,1,2,0.5,0.5
"8913",8913,1,1,2,0.5,0.5
"8914",8914,1,1,2,0.5,0.5
"8915",8915,1,1,2,0.5,0.5
"8916",8916,1,1,2,0.5,0.5
"8917",8917,1,1,2,0.5,0.5
"8918",8918,1,1,2,0.5,0.5
"8919",8919,1,1,2,0.5,0.5
"8920",8920,1,1,2,0.5,0.5
"8921",8921,1,1,2,0.5,0.5
"8922",8922,1,1,2,0.5,0.5
"8923",8923,1,1,2,0.5,0.5
"8924",8924,1,1,2,0.5,0.5
"8925",8925,1,1,2,0.5,0.5
"8926",8926,1,1,2,0.5,0.5
"8927",8927,1,1,2,0.5,0.5
"8928",8928,1,1,2,0.5,0.5
"8929",8929,1,1,2,0.5,0.5
"8930",8930,1,1,2,0.5,0.5
"8931",8931,1,1,2,0.5,0.5
"8932",8932,1,1,2,0.5,0.5
"8933",8933,1,1,2,0.5,0.5
"8934",8934,1,1,2,0.5,0.5
"8935",8935,1,1,2,0.5,0.5
"8936",8936,1,1,2,0.5,0.5
"8937",8937,1,1,2,0.5,0.5
"8938",8938,1,1,2,0.5,0.5
"8939",8939,1,1,2,0.5,0.5
"8940",8940,1,1,2,0.5,0.5
"8941",8941,1,1,2,0.5,0.5
"8942",8942,1,1,2,0.5,0.5
"8943",8943,1,1,2,0.5,0.5
"8944",8944,1,1,2,0.5,0.5
"8945",8945,1,1,2,0.5,0.5
"8946",8946,1,1,2,0.5,0.5
"8947",8947,1,1,2,0.5,0.5
"8948",8948,1,1,2,0.5,0.5
"8949",8949,1,1,2,0.5,0.5
"8950",8950,1,1,2,0.5,0.5
"8951",8951,1,1,2,0.5,0.5
"8952",8952,1,1,2,0.5,0.5
"8953",8953,1,1,2,0.5,0.5
"8954",8954,1,1,2,0.5,0.5
"8955",8955,1,1,2,0.5,0.5
"8956",8956,1,1,2,0.5,0.5
"8957",8957,1,1,2,0.5,0.5
"8958",8958,1,1,2,0.5,0.5
"8959",8959,1,1,2,0.5,0.5
"8960",8960,1,1,2,0.5,0.5
"8961",8961,1,1,2,0.5,0.5
"8962",8962,1,1,2,0.5,0.5
"8963",8963,1,1,2,0.5,0.5
"8964",8964,1,1,2,0.5,0.5
"8965",8965,1,1,2,0.5,0.5
"8966",8966,1,1,2,0.5,0.5
"8967",8967,1,1,2,0.5,0.5
"8968",8968,1,1,2,0.5,0.5
"8969",8969,1,1,2,0.5,0.5
"8970",8970,1,1,2,0.5,0.5
"8971",8971,1,1,2,0.5,0.5
"8972",8972,1,1,2,0.5,0.5
"8973",8973,1,1,2,0.5,0.5
"8974",8974,1,1,2,0.5,0.5
"8975",8975,1,1,2,0.5,0.5
"8976",8976,1,1,2,0.5,0.5
"8977",8977,1,1,2,0.5,0.5
"8978",8978,1,1,2,0.5,0.5
"8979",8979,1,1,2,0.5,0.5
"8980",8980,1,1,2,0.5,0.5
"8981",8981,1,1,2,0.5,0.5
"8982",8982,1,1,2,0.5,0.5
"8983",8983,1,1,2,0.5,0.5
"8984",8984,1,1,2,0.5,0.5
"8985",8985,1,1,2,0.5,0.5
"8986",8986,1,1,2,0.5,0.5
"8987",8987,1,1,2,0.5,0.5
"8988",8988,1,1,2,0.5,0.5
"8989",8989,1,1,2,0.5,0.5
"8990",8990,1,1,2,0.5,0.5
"8991",8991,1,1,2,0.5,0.5
"8992",8992,1,1,2,0.5,0.5
"8993",8993,1,1,2,0.5,0.5
"8994",8994,1,1,2,0.5,0.5
"8995",8995,1,1,2,0.5,0.5
"8996",8996,1,1,2,0.5,0.5
"8997",8997,1,1,2,0.5,0.5
"8998",8998,1,1,2,0.5,0.5
"8999",8999,1,1,2,0.5,0.5
"9000",9000,1,1,2,0.5,0.5
"9001",9001,1,1,2,0.5,0.5
"9002",9002,1,1,2,0.5,0.5
"9003",9003,1,1,2,0.5,0.5
"9004",9004,1,1,2,0.5,0.5
